"filename", "language", "Makefile", "C++", "Python", "Markdown", "XML", "comment", "blank", "total"
"/home/sanjay/Desktop/Bitbucket/MarlinV2_morphle/Marlin/Configuration.h", "C++", 0, -605, 0, 0, 0, -2131, -450, -3186
"/home/sanjay/Desktop/Bitbucket/MarlinV2_morphle/Marlin/Configuration_adv.h", "C++", 0, -1426, 0, 0, 0, -2386, -550, -4362
"/home/sanjay/Desktop/Bitbucket/MarlinV2_morphle/Marlin/Makefile", "Makefile", -588, 0, 0, 0, 0, -322, -126, -1036
"/home/sanjay/Desktop/Bitbucket/MarlinV2_morphle/Marlin/Marlin.ino", "C++", 0, 0, 0, 0, 0, -57, -1, -58
"/home/sanjay/Desktop/Bitbucket/MarlinV2_morphle/Marlin/Version.h", "C++", 0, -1, 0, 0, 0, -66, -10, -77
"/home/sanjay/Desktop/Bitbucket/MarlinV2_morphle/Marlin/src/HAL/HAL.h", "C++", 0, -17, 0, 0, 0, -23, -8, -48
"/home/sanjay/Desktop/Bitbucket/MarlinV2_morphle/Marlin/src/HAL/STM32/HAL.cpp", "C++", 0, -119, 0, 0, 0, -39, -37, -195
"/home/sanjay/Desktop/Bitbucket/MarlinV2_morphle/Marlin/src/HAL/STM32/HAL.h", "C++", 0, -155, 0, 0, 0, -74, -54, -283
"/home/sanjay/Desktop/Bitbucket/MarlinV2_morphle/Marlin/src/HAL/STM32/HAL_SPI.cpp", "C++", 0, -112, 0, 0, 0, -86, -34, -232
"/home/sanjay/Desktop/Bitbucket/MarlinV2_morphle/Marlin/src/HAL/STM32/MarlinSPI.cpp", "C++", 0, -121, 0, 0, 0, -30, -24, -175
"/home/sanjay/Desktop/Bitbucket/MarlinV2_morphle/Marlin/src/HAL/STM32/MarlinSPI.h", "C++", 0, -52, 0, 0, 0, -42, -14, -108
"/home/sanjay/Desktop/Bitbucket/MarlinV2_morphle/Marlin/src/HAL/STM32/MarlinSerial.cpp", "C++", 0, -68, 0, 0, 0, -28, -15, -111
"/home/sanjay/Desktop/Bitbucket/MarlinV2_morphle/Marlin/src/HAL/STM32/MarlinSerial.h", "C++", 0, -29, 0, 0, 0, -21, -10, -60
"/home/sanjay/Desktop/Bitbucket/MarlinV2_morphle/Marlin/src/HAL/STM32/MinSerial.cpp", "C++", 0, -98, 0, 0, 0, -35, -21, -154
"/home/sanjay/Desktop/Bitbucket/MarlinV2_morphle/Marlin/src/HAL/STM32/README.md", "Markdown", 0, 0, 0, -8, 0, 0, -4, -12
"/home/sanjay/Desktop/Bitbucket/MarlinV2_morphle/Marlin/src/HAL/STM32/Servo.cpp", "C++", 0, -67, 0, 0, 0, -28, -18, -113
"/home/sanjay/Desktop/Bitbucket/MarlinV2_morphle/Marlin/src/HAL/STM32/Servo.h", "C++", 0, -23, 0, 0, 0, -23, -9, -55
"/home/sanjay/Desktop/Bitbucket/MarlinV2_morphle/Marlin/src/HAL/STM32/eeprom_bl24cxx.cpp", "C++", 0, -44, 0, 0, 0, -28, -14, -86
"/home/sanjay/Desktop/Bitbucket/MarlinV2_morphle/Marlin/src/HAL/STM32/eeprom_flash.cpp", "C++", 0, -177, 0, 0, 0, -52, -49, -278
"/home/sanjay/Desktop/Bitbucket/MarlinV2_morphle/Marlin/src/HAL/STM32/eeprom_if_iic.cpp", "C++", 0, -17, 0, 0, 0, -28, -12, -57
"/home/sanjay/Desktop/Bitbucket/MarlinV2_morphle/Marlin/src/HAL/STM32/eeprom_sdcard.cpp", "C++", 0, -53, 0, 0, 0, -24, -18, -95
"/home/sanjay/Desktop/Bitbucket/MarlinV2_morphle/Marlin/src/HAL/STM32/eeprom_sram.cpp", "C++", 0, -34, 0, 0, 0, -24, -13, -71
"/home/sanjay/Desktop/Bitbucket/MarlinV2_morphle/Marlin/src/HAL/STM32/eeprom_wired.cpp", "C++", 0, -43, 0, 0, 0, -27, -11, -81
"/home/sanjay/Desktop/Bitbucket/MarlinV2_morphle/Marlin/src/HAL/STM32/endstop_interrupts.h", "C++", 0, -29, 0, 0, 0, -23, -4, -56
"/home/sanjay/Desktop/Bitbucket/MarlinV2_morphle/Marlin/src/HAL/STM32/fast_pwm.cpp", "C++", 0, -50, 0, 0, 0, -25, -14, -89
"/home/sanjay/Desktop/Bitbucket/MarlinV2_morphle/Marlin/src/HAL/STM32/fastio.cpp", "C++", 0, -9, 0, 0, 0, -22, -6, -37
"/home/sanjay/Desktop/Bitbucket/MarlinV2_morphle/Marlin/src/HAL/STM32/fastio.h", "C++", 0, -38, 0, 0, 0, -36, -18, -92
"/home/sanjay/Desktop/Bitbucket/MarlinV2_morphle/Marlin/src/HAL/STM32/inc/Conditionals_LCD.h", "C++", 0, -1, 0, 0, 0, -21, -1, -23
"/home/sanjay/Desktop/Bitbucket/MarlinV2_morphle/Marlin/src/HAL/STM32/inc/Conditionals_adv.h", "C++", 0, -9, 0, 0, 0, -23, -4, -36
"/home/sanjay/Desktop/Bitbucket/MarlinV2_morphle/Marlin/src/HAL/STM32/inc/Conditionals_post.h", "C++", 0, -6, 0, 0, 0, -22, -2, -30
"/home/sanjay/Desktop/Bitbucket/MarlinV2_morphle/Marlin/src/HAL/STM32/inc/SanityCheck.h", "C++", 0, -23, 0, 0, 0, -27, -8, -58
"/home/sanjay/Desktop/Bitbucket/MarlinV2_morphle/Marlin/src/HAL/STM32/msc_sd.cpp", "C++", 0, -90, 0, 0, 0, -21, -20, -131
"/home/sanjay/Desktop/Bitbucket/MarlinV2_morphle/Marlin/src/HAL/STM32/msc_sd.h", "C++", 0, -2, 0, 0, 0, -15, -2, -19
"/home/sanjay/Desktop/Bitbucket/MarlinV2_morphle/Marlin/src/HAL/STM32/pinsDebug.h", "C++", 0, -172, 0, 0, 0, -82, -30, -284
"/home/sanjay/Desktop/Bitbucket/MarlinV2_morphle/Marlin/src/HAL/STM32/pins_Xref.h", "C++", 0, -576, 0, 0, 0, -24, -13, -613
"/home/sanjay/Desktop/Bitbucket/MarlinV2_morphle/Marlin/src/HAL/STM32/sdio.cpp", "C++", 0, -287, 0, 0, 0, -83, -82, -452
"/home/sanjay/Desktop/Bitbucket/MarlinV2_morphle/Marlin/src/HAL/STM32/sdio.h", "C++", 0, -7, 0, 0, 0, -21, -2, -30
"/home/sanjay/Desktop/Bitbucket/MarlinV2_morphle/Marlin/src/HAL/STM32/spi_pins.h", "C++", 0, -13, 0, 0, 0, -24, -2, -39
"/home/sanjay/Desktop/Bitbucket/MarlinV2_morphle/Marlin/src/HAL/STM32/tft/gt911.cpp", "C++", 0, -145, 0, 0, 0, -27, -37, -209
"/home/sanjay/Desktop/Bitbucket/MarlinV2_morphle/Marlin/src/HAL/STM32/tft/gt911.h", "C++", 0, -88, 0, 0, 0, -22, -11, -121
"/home/sanjay/Desktop/Bitbucket/MarlinV2_morphle/Marlin/src/HAL/STM32/tft/tft_fsmc.cpp", "C++", 0, -123, 0, 0, 0, -27, -25, -175
"/home/sanjay/Desktop/Bitbucket/MarlinV2_morphle/Marlin/src/HAL/STM32/tft/tft_fsmc.h", "C++", 0, -132, 0, 0, 0, -21, -19, -172
"/home/sanjay/Desktop/Bitbucket/MarlinV2_morphle/Marlin/src/HAL/STM32/tft/tft_ltdc.cpp", "C++", 0, -250, 0, 0, 0, -67, -73, -390
"/home/sanjay/Desktop/Bitbucket/MarlinV2_morphle/Marlin/src/HAL/STM32/tft/tft_ltdc.h", "C++", 0, -117, 0, 0, 0, -21, -18, -156
"/home/sanjay/Desktop/Bitbucket/MarlinV2_morphle/Marlin/src/HAL/STM32/tft/tft_spi.cpp", "C++", 0, -193, 0, 0, 0, -28, -50, -271
"/home/sanjay/Desktop/Bitbucket/MarlinV2_morphle/Marlin/src/HAL/STM32/tft/tft_spi.h", "C++", 0, -50, 0, 0, 0, -21, -14, -85
"/home/sanjay/Desktop/Bitbucket/MarlinV2_morphle/Marlin/src/HAL/STM32/tft/xpt2046.cpp", "C++", 0, -120, 0, 0, 0, -22, -32, -174
"/home/sanjay/Desktop/Bitbucket/MarlinV2_morphle/Marlin/src/HAL/STM32/tft/xpt2046.h", "C++", 0, -46, 0, 0, 0, -22, -14, -82
"/home/sanjay/Desktop/Bitbucket/MarlinV2_morphle/Marlin/src/HAL/STM32/timers.cpp", "C++", 0, -211, 0, 0, 0, -84, -36, -331
"/home/sanjay/Desktop/Bitbucket/MarlinV2_morphle/Marlin/src/HAL/STM32/timers.h", "C++", 0, -51, 0, 0, 0, -49, -21, -121
"/home/sanjay/Desktop/Bitbucket/MarlinV2_morphle/Marlin/src/HAL/STM32/usb_host.cpp", "C++", 0, -74, 0, 0, 0, -28, -18, -120
"/home/sanjay/Desktop/Bitbucket/MarlinV2_morphle/Marlin/src/HAL/STM32/usb_host.h", "C++", 0, -32, 0, 0, 0, -21, -8, -61
"/home/sanjay/Desktop/Bitbucket/MarlinV2_morphle/Marlin/src/HAL/STM32/usb_serial.cpp", "C++", 0, -27, 0, 0, 0, -21, -13, -61
"/home/sanjay/Desktop/Bitbucket/MarlinV2_morphle/Marlin/src/HAL/STM32/usb_serial.h", "C++", 0, -2, 0, 0, 0, -21, -2, -25
"/home/sanjay/Desktop/Bitbucket/MarlinV2_morphle/Marlin/src/HAL/STM32F1/HAL.cpp", "C++", 0, -216, 0, 0, 0, -117, -55, -388
"/home/sanjay/Desktop/Bitbucket/MarlinV2_morphle/Marlin/src/HAL/STM32F1/HAL.h", "C++", 0, -166, 0, 0, 0, -81, -63, -310
"/home/sanjay/Desktop/Bitbucket/MarlinV2_morphle/Marlin/src/HAL/STM32F1/HAL_SPI.cpp", "C++", 0, -56, 0, 0, 0, -93, -23, -172
"/home/sanjay/Desktop/Bitbucket/MarlinV2_morphle/Marlin/src/HAL/STM32F1/MarlinSPI.h", "C++", 0, -3, 0, 0, 0, -39, -4, -46
"/home/sanjay/Desktop/Bitbucket/MarlinV2_morphle/Marlin/src/HAL/STM32F1/MarlinSerial.cpp", "C++", 0, -143, 0, 0, 0, -47, -15, -205
"/home/sanjay/Desktop/Bitbucket/MarlinV2_morphle/Marlin/src/HAL/STM32F1/MarlinSerial.h", "C++", 0, -27, 0, 0, 0, -23, -9, -59
"/home/sanjay/Desktop/Bitbucket/MarlinV2_morphle/Marlin/src/HAL/STM32F1/MinSerial.cpp", "C++", 0, -63, 0, 0, 0, -36, -19, -118
"/home/sanjay/Desktop/Bitbucket/MarlinV2_morphle/Marlin/src/HAL/STM32F1/README.md", "Markdown", 0, 0, 0, -8, 0, 0, -4, -12
"/home/sanjay/Desktop/Bitbucket/MarlinV2_morphle/Marlin/src/HAL/STM32F1/SPI.cpp", "C++", 0, -505, 0, 0, 0, -153, -81, -739
"/home/sanjay/Desktop/Bitbucket/MarlinV2_morphle/Marlin/src/HAL/STM32F1/SPI.h", "C++", 0, -147, 0, 0, 0, -214, -57, -418
"/home/sanjay/Desktop/Bitbucket/MarlinV2_morphle/Marlin/src/HAL/STM32F1/Servo.cpp", "C++", 0, -159, 0, 0, 0, -33, -35, -227
"/home/sanjay/Desktop/Bitbucket/MarlinV2_morphle/Marlin/src/HAL/STM32F1/Servo.h", "C++", 0, -31, 0, 0, 0, -23, -8, -62
"/home/sanjay/Desktop/Bitbucket/MarlinV2_morphle/Marlin/src/HAL/STM32F1/build_flags.py", "Python", 0, 0, -44, 0, 0, -2, -11, -57
"/home/sanjay/Desktop/Bitbucket/MarlinV2_morphle/Marlin/src/HAL/STM32F1/dogm/u8g_com_stm32duino_swspi.cpp", "C++", 0, -123, 0, 0, 0, -23, -25, -171
"/home/sanjay/Desktop/Bitbucket/MarlinV2_morphle/Marlin/src/HAL/STM32F1/eeprom_bl24cxx.cpp", "C++", 0, -43, 0, 0, 0, -28, -12, -83
"/home/sanjay/Desktop/Bitbucket/MarlinV2_morphle/Marlin/src/HAL/STM32F1/eeprom_flash.cpp", "C++", 0, -56, 0, 0, 0, -34, -24, -114
"/home/sanjay/Desktop/Bitbucket/MarlinV2_morphle/Marlin/src/HAL/STM32F1/eeprom_if_iic.cpp", "C++", 0, -16, 0, 0, 0, -28, -11, -55
"/home/sanjay/Desktop/Bitbucket/MarlinV2_morphle/Marlin/src/HAL/STM32F1/eeprom_sdcard.cpp", "C++", 0, -52, 0, 0, 0, -25, -17, -94
"/home/sanjay/Desktop/Bitbucket/MarlinV2_morphle/Marlin/src/HAL/STM32F1/eeprom_wired.cpp", "C++", 0, -54, 0, 0, 0, -24, -12, -90
"/home/sanjay/Desktop/Bitbucket/MarlinV2_morphle/Marlin/src/HAL/STM32F1/endstop_interrupts.h", "C++", 0, -29, 0, 0, 0, -46, -6, -81
"/home/sanjay/Desktop/Bitbucket/MarlinV2_morphle/Marlin/src/HAL/STM32F1/fast_pwm.cpp", "C++", 0, -50, 0, 0, 0, -23, -13, -86
"/home/sanjay/Desktop/Bitbucket/MarlinV2_morphle/Marlin/src/HAL/STM32F1/fastio.h", "C++", 0, -140, 0, 0, 0, -30, -17, -187
"/home/sanjay/Desktop/Bitbucket/MarlinV2_morphle/Marlin/src/HAL/STM32F1/inc/Conditionals_LCD.h", "C++", 0, -1, 0, 0, 0, -21, -1, -23
"/home/sanjay/Desktop/Bitbucket/MarlinV2_morphle/Marlin/src/HAL/STM32F1/inc/Conditionals_adv.h", "C++", 0, -7, 0, 0, 0, -22, -2, -31
"/home/sanjay/Desktop/Bitbucket/MarlinV2_morphle/Marlin/src/HAL/STM32F1/inc/Conditionals_post.h", "C++", 0, -9, 0, 0, 0, -23, -3, -35
"/home/sanjay/Desktop/Bitbucket/MarlinV2_morphle/Marlin/src/HAL/STM32F1/inc/SanityCheck.h", "C++", 0, -19, 0, 0, 0, -27, -6, -52
"/home/sanjay/Desktop/Bitbucket/MarlinV2_morphle/Marlin/src/HAL/STM32F1/msc_sd.cpp", "C++", 0, -53, 0, 0, 0, -26, -20, -99
"/home/sanjay/Desktop/Bitbucket/MarlinV2_morphle/Marlin/src/HAL/STM32F1/msc_sd.h", "C++", 0, -7, 0, 0, 0, -15, -5, -27
"/home/sanjay/Desktop/Bitbucket/MarlinV2_morphle/Marlin/src/HAL/STM32F1/onboard_sd.cpp", "C++", 0, -407, 0, 0, 0, -70, -95, -572
"/home/sanjay/Desktop/Bitbucket/MarlinV2_morphle/Marlin/src/HAL/STM32F1/onboard_sd.h", "C++", 0, -63, 0, 0, 0, -17, -17, -97
"/home/sanjay/Desktop/Bitbucket/MarlinV2_morphle/Marlin/src/HAL/STM32F1/pinsDebug.h", "C++", 0, -80, 0, 0, 0, -28, -16, -124
"/home/sanjay/Desktop/Bitbucket/MarlinV2_morphle/Marlin/src/HAL/STM32F1/sdio.cpp", "C++", 0, -209, 0, 0, 0, -29, -70, -308
"/home/sanjay/Desktop/Bitbucket/MarlinV2_morphle/Marlin/src/HAL/STM32F1/sdio.h", "C++", 0, -100, 0, 0, 0, -30, -26, -156
"/home/sanjay/Desktop/Bitbucket/MarlinV2_morphle/Marlin/src/HAL/STM32F1/spi_pins.h", "C++", 0, -18, 0, 0, 0, -36, -4, -58
"/home/sanjay/Desktop/Bitbucket/MarlinV2_morphle/Marlin/src/HAL/STM32F1/tft/tft_fsmc.cpp", "C++", 0, -175, 0, 0, 0, -25, -38, -238
"/home/sanjay/Desktop/Bitbucket/MarlinV2_morphle/Marlin/src/HAL/STM32F1/tft/tft_fsmc.h", "C++", 0, -40, 0, 0, 0, -21, -11, -72
"/home/sanjay/Desktop/Bitbucket/MarlinV2_morphle/Marlin/src/HAL/STM32F1/tft/tft_spi.cpp", "C++", 0, -83, 0, 0, 0, -26, -21, -130
"/home/sanjay/Desktop/Bitbucket/MarlinV2_morphle/Marlin/src/HAL/STM32F1/tft/tft_spi.h", "C++", 0, -40, 0, 0, 0, -21, -12, -73
"/home/sanjay/Desktop/Bitbucket/MarlinV2_morphle/Marlin/src/HAL/STM32F1/tft/xpt2046.cpp", "C++", 0, -90, 0, 0, 0, -28, -27, -145
"/home/sanjay/Desktop/Bitbucket/MarlinV2_morphle/Marlin/src/HAL/STM32F1/tft/xpt2046.h", "C++", 0, -51, 0, 0, 0, -21, -12, -84
"/home/sanjay/Desktop/Bitbucket/MarlinV2_morphle/Marlin/src/HAL/STM32F1/timers.cpp", "C++", 0, -118, 0, 0, 0, -48, -18, -184
"/home/sanjay/Desktop/Bitbucket/MarlinV2_morphle/Marlin/src/HAL/STM32F1/timers.h", "C++", 0, -97, 0, 0, 0, -72, -33, -202
"/home/sanjay/Desktop/Bitbucket/MarlinV2_morphle/Marlin/src/HAL/platforms.h", "C++", 0, -32, 0, 0, 0, -21, -3, -56
"/home/sanjay/Desktop/Bitbucket/MarlinV2_morphle/Marlin/src/HAL/shared/Delay.cpp", "C++", 0, -108, 0, 0, 0, -41, -30, -179
"/home/sanjay/Desktop/Bitbucket/MarlinV2_morphle/Marlin/src/HAL/shared/Delay.h", "C++", 0, -123, 0, 0, 0, -67, -30, -220
"/home/sanjay/Desktop/Bitbucket/MarlinV2_morphle/Marlin/src/HAL/shared/HAL.cpp", "C++", 0, -5, 0, 0, 0, -25, -7, -37
"/home/sanjay/Desktop/Bitbucket/MarlinV2_morphle/Marlin/src/HAL/shared/HAL_SPI.h", "C++", 0, -20, 0, 0, 0, -57, -17, -94
"/home/sanjay/Desktop/Bitbucket/MarlinV2_morphle/Marlin/src/HAL/shared/HAL_ST7920.h", "C++", 0, -8, 0, 0, 0, -26, -3, -37
"/home/sanjay/Desktop/Bitbucket/MarlinV2_morphle/Marlin/src/HAL/shared/HAL_spi_L6470.cpp", "C++", 0, -73, 0, 0, 0, -38, -29, -140
"/home/sanjay/Desktop/Bitbucket/MarlinV2_morphle/Marlin/src/HAL/shared/Marduino.h", "C++", 0, -55, 0, 0, 0, -27, -15, -97
"/home/sanjay/Desktop/Bitbucket/MarlinV2_morphle/Marlin/src/HAL/shared/MinSerial.cpp", "C++", 0, -8, 0, 0, 0, -21, -5, -34
"/home/sanjay/Desktop/Bitbucket/MarlinV2_morphle/Marlin/src/HAL/shared/MinSerial.h", "C++", 0, -42, 0, 0, 0, -31, -7, -80
"/home/sanjay/Desktop/Bitbucket/MarlinV2_morphle/Marlin/src/HAL/shared/backtrace/backtrace.cpp", "C++", 0, -62, 0, 0, 0, -27, -18, -107
"/home/sanjay/Desktop/Bitbucket/MarlinV2_morphle/Marlin/src/HAL/shared/backtrace/backtrace.h", "C++", 0, -3, 0, 0, 0, -23, -3, -29
"/home/sanjay/Desktop/Bitbucket/MarlinV2_morphle/Marlin/src/HAL/shared/backtrace/unwarm.cpp", "C++", 0, -76, 0, 0, 0, -69, -31, -176
"/home/sanjay/Desktop/Bitbucket/MarlinV2_morphle/Marlin/src/HAL/shared/backtrace/unwarm.h", "C++", 0, -56, 0, 0, 0, -59, -26, -141
"/home/sanjay/Desktop/Bitbucket/MarlinV2_morphle/Marlin/src/HAL/shared/backtrace/unwarm_arm.cpp", "C++", 0, -332, 0, 0, 0, -109, -94, -535
"/home/sanjay/Desktop/Bitbucket/MarlinV2_morphle/Marlin/src/HAL/shared/backtrace/unwarm_thumb.cpp", "C++", 0, -608, 0, 0, 0, -266, -193, -1067
"/home/sanjay/Desktop/Bitbucket/MarlinV2_morphle/Marlin/src/HAL/shared/backtrace/unwarmbytab.cpp", "C++", 0, -258, 0, 0, 0, -98, -75, -431
"/home/sanjay/Desktop/Bitbucket/MarlinV2_morphle/Marlin/src/HAL/shared/backtrace/unwarmbytab.h", "C++", 0, -13, 0, 0, 0, -13, -6, -32
"/home/sanjay/Desktop/Bitbucket/MarlinV2_morphle/Marlin/src/HAL/shared/backtrace/unwarmmem.cpp", "C++", 0, -63, 0, 0, 0, -24, -20, -107
"/home/sanjay/Desktop/Bitbucket/MarlinV2_morphle/Marlin/src/HAL/shared/backtrace/unwarmmem.h", "C++", 0, -5, 0, 0, 0, -13, -4, -22
"/home/sanjay/Desktop/Bitbucket/MarlinV2_morphle/Marlin/src/HAL/shared/backtrace/unwinder.cpp", "C++", 0, -23, 0, 0, 0, -20, -10, -53
"/home/sanjay/Desktop/Bitbucket/MarlinV2_morphle/Marlin/src/HAL/shared/backtrace/unwinder.h", "C++", 0, -47, 0, 0, 0, -89, -37, -173
"/home/sanjay/Desktop/Bitbucket/MarlinV2_morphle/Marlin/src/HAL/shared/backtrace/unwmemaccess.cpp", "C++", 0, -102, 0, 0, 0, -68, -41, -211
"/home/sanjay/Desktop/Bitbucket/MarlinV2_morphle/Marlin/src/HAL/shared/backtrace/unwmemaccess.h", "C++", 0, -6, 0, 0, 0, -13, -4, -23
"/home/sanjay/Desktop/Bitbucket/MarlinV2_morphle/Marlin/src/HAL/shared/cpu_exception/exception_arm.cpp", "C++", 0, -204, 0, 0, 0, -122, -54, -380
"/home/sanjay/Desktop/Bitbucket/MarlinV2_morphle/Marlin/src/HAL/shared/cpu_exception/exception_hook.cpp", "C++", 0, -6, 0, 0, 0, -21, -2, -29
"/home/sanjay/Desktop/Bitbucket/MarlinV2_morphle/Marlin/src/HAL/shared/cpu_exception/exception_hook.h", "C++", 0, -7, 0, 0, 0, -43, -5, -55
"/home/sanjay/Desktop/Bitbucket/MarlinV2_morphle/Marlin/src/HAL/shared/eeprom_api.cpp", "C++", 0, -5, 0, 0, 0, -22, -4, -31
"/home/sanjay/Desktop/Bitbucket/MarlinV2_morphle/Marlin/src/HAL/shared/eeprom_api.h", "C++", 0, -24, 0, 0, 0, -35, -13, -72
"/home/sanjay/Desktop/Bitbucket/MarlinV2_morphle/Marlin/src/HAL/shared/eeprom_if.h", "C++", 0, -4, 0, 0, 0, -24, -2, -30
"/home/sanjay/Desktop/Bitbucket/MarlinV2_morphle/Marlin/src/HAL/shared/eeprom_if_i2c.cpp", "C++", 0, -52, 0, 0, 0, -33, -18, -103
"/home/sanjay/Desktop/Bitbucket/MarlinV2_morphle/Marlin/src/HAL/shared/eeprom_if_spi.cpp", "C++", 0, -40, 0, 0, 0, -26, -19, -85
"/home/sanjay/Desktop/Bitbucket/MarlinV2_morphle/Marlin/src/HAL/shared/esp_wifi.cpp", "C++", 0, -20, 0, 0, 0, -21, -3, -44
"/home/sanjay/Desktop/Bitbucket/MarlinV2_morphle/Marlin/src/HAL/shared/esp_wifi.h", "C++", 0, -2, 0, 0, 0, -21, -2, -25
"/home/sanjay/Desktop/Bitbucket/MarlinV2_morphle/Marlin/src/HAL/shared/math_32bit.h", "C++", 0, -5, 0, 0, 0, -24, -3, -32
"/home/sanjay/Desktop/Bitbucket/MarlinV2_morphle/Marlin/src/HAL/shared/progmem.h", "C++", 0, -159, 0, 0, 0, -24, -8, -191
"/home/sanjay/Desktop/Bitbucket/MarlinV2_morphle/Marlin/src/HAL/shared/servo.cpp", "C++", 0, -72, 0, 0, 0, -58, -28, -158
"/home/sanjay/Desktop/Bitbucket/MarlinV2_morphle/Marlin/src/HAL/shared/servo.h", "C++", 0, -40, 0, 0, 0, -67, -9, -116
"/home/sanjay/Desktop/Bitbucket/MarlinV2_morphle/Marlin/src/HAL/shared/servo_private.h", "C++", 0, -36, 0, 0, 0, -46, -17, -99
"/home/sanjay/Desktop/Bitbucket/MarlinV2_morphle/Marlin/src/MarlinCore.cpp", "C++", 0, -1144, 0, 0, 0, -254, -274, -1672
"/home/sanjay/Desktop/Bitbucket/MarlinV2_morphle/Marlin/src/MarlinCore.h", "C++", 0, -47, 0, 0, 0, -23, -17, -87
"/home/sanjay/Desktop/Bitbucket/MarlinV2_morphle/Marlin/src/core/boards.h", "C++", 0, -348, 0, 0, 0, -81, -47, -476
"/home/sanjay/Desktop/Bitbucket/MarlinV2_morphle/Marlin/src/core/bug_on.h", "C++", 0, -9, 0, 0, 0, -28, -3, -40
"/home/sanjay/Desktop/Bitbucket/MarlinV2_morphle/Marlin/src/core/debug_out.h", "C++", 0, -85, 0, 0, 0, -26, -10, -121
"/home/sanjay/Desktop/Bitbucket/MarlinV2_morphle/Marlin/src/core/debug_section.h", "C++", 0, -23, 0, 0, 0, -21, -6, -50
"/home/sanjay/Desktop/Bitbucket/MarlinV2_morphle/Marlin/src/core/drivers.h", "C++", 0, -134, 0, 0, 0, -38, -32, -204
"/home/sanjay/Desktop/Bitbucket/MarlinV2_morphle/Marlin/src/core/language.h", "C++", 0, -422, 0, 0, 0, -94, -49, -565
"/home/sanjay/Desktop/Bitbucket/MarlinV2_morphle/Marlin/src/core/macros.h", "C++", 0, -554, 0, 0, 0, -76, -91, -721
"/home/sanjay/Desktop/Bitbucket/MarlinV2_morphle/Marlin/src/core/millis_t.h", "C++", 0, -8, 0, 0, 0, -21, -5, -34
"/home/sanjay/Desktop/Bitbucket/MarlinV2_morphle/Marlin/src/core/multi_language.h", "C++", 0, -56, 0, 0, 0, -27, -11, -94
"/home/sanjay/Desktop/Bitbucket/MarlinV2_morphle/Marlin/src/core/serial.cpp", "C++", 0, -67, 0, 0, 0, -25, -19, -111
"/home/sanjay/Desktop/Bitbucket/MarlinV2_morphle/Marlin/src/core/serial.h", "C++", 0, -238, 0, 0, 0, -73, -64, -375
"/home/sanjay/Desktop/Bitbucket/MarlinV2_morphle/Marlin/src/core/serial_base.h", "C++", 0, -135, 0, 0, 0, -79, -45, -259
"/home/sanjay/Desktop/Bitbucket/MarlinV2_morphle/Marlin/src/core/serial_hook.h", "C++", 0, -208, 0, 0, 0, -46, -55, -309
"/home/sanjay/Desktop/Bitbucket/MarlinV2_morphle/Marlin/src/core/types.h", "C++", 0, -542, 0, 0, 0, -113, -89, -744
"/home/sanjay/Desktop/Bitbucket/MarlinV2_morphle/Marlin/src/core/utility.cpp", "C++", 0, -131, 0, 0, 0, -22, -26, -179
"/home/sanjay/Desktop/Bitbucket/MarlinV2_morphle/Marlin/src/core/utility.h", "C++", 0, -52, 0, 0, 0, -30, -13, -95
"/home/sanjay/Desktop/Bitbucket/MarlinV2_morphle/Marlin/src/feature/adc/adc_mcp3426.cpp", "C++", 0, -46, 0, 0, 0, -37, -22, -105
"/home/sanjay/Desktop/Bitbucket/MarlinV2_morphle/Marlin/src/feature/adc/adc_mcp3426.h", "C++", 0, -9, 0, 0, 0, -25, -5, -39
"/home/sanjay/Desktop/Bitbucket/MarlinV2_morphle/Marlin/src/feature/ammeter.cpp", "C++", 0, -23, 0, 0, 0, -21, -11, -55
"/home/sanjay/Desktop/Bitbucket/MarlinV2_morphle/Marlin/src/feature/ammeter.h", "C++", 0, -13, 0, 0, 0, -21, -6, -40
"/home/sanjay/Desktop/Bitbucket/MarlinV2_morphle/Marlin/src/feature/babystep.cpp", "C++", 0, -35, 0, 0, 0, -21, -12, -68
"/home/sanjay/Desktop/Bitbucket/MarlinV2_morphle/Marlin/src/feature/babystep.h", "C++", 0, -46, 0, 0, 0, -25, -12, -83
"/home/sanjay/Desktop/Bitbucket/MarlinV2_morphle/Marlin/src/feature/backlash.cpp", "C++", 0, -130, 0, 0, 0, -49, -39, -218
"/home/sanjay/Desktop/Bitbucket/MarlinV2_morphle/Marlin/src/feature/backlash.h", "C++", 0, -61, 0, 0, 0, -22, -14, -97
"/home/sanjay/Desktop/Bitbucket/MarlinV2_morphle/Marlin/src/feature/baricuda.cpp", "C++", 0, -6, 0, 0, 0, -21, -6, -33
"/home/sanjay/Desktop/Bitbucket/MarlinV2_morphle/Marlin/src/feature/baricuda.h", "C++", 0, -3, 0, 0, 0, -21, -2, -26
"/home/sanjay/Desktop/Bitbucket/MarlinV2_morphle/Marlin/src/feature/bedlevel/abl/bbl.cpp", "C++", 0, -300, 0, 0, 0, -76, -64, -440
"/home/sanjay/Desktop/Bitbucket/MarlinV2_morphle/Marlin/src/feature/bedlevel/abl/bbl.h", "C++", 0, -39, 0, 0, 0, -21, -11, -71
"/home/sanjay/Desktop/Bitbucket/MarlinV2_morphle/Marlin/src/feature/bedlevel/bedlevel.cpp", "C++", 0, -138, 0, 0, 0, -44, -36, -218
"/home/sanjay/Desktop/Bitbucket/MarlinV2_morphle/Marlin/src/feature/bedlevel/bedlevel.h", "C++", 0, -54, 0, 0, 0, -28, -18, -100
"/home/sanjay/Desktop/Bitbucket/MarlinV2_morphle/Marlin/src/feature/bedlevel/hilbert_curve.cpp", "C++", 0, -52, 0, 0, 0, -44, -15, -111
"/home/sanjay/Desktop/Bitbucket/MarlinV2_morphle/Marlin/src/feature/bedlevel/hilbert_curve.h", "C++", 0, -10, 0, 0, 0, -19, -4, -33
"/home/sanjay/Desktop/Bitbucket/MarlinV2_morphle/Marlin/src/feature/bedlevel/mbl/mesh_bed_leveling.cpp", "C++", 0, -74, 0, 0, 0, -36, -22, -132
"/home/sanjay/Desktop/Bitbucket/MarlinV2_morphle/Marlin/src/feature/bedlevel/mbl/mesh_bed_leveling.h", "C++", 0, -83, 0, 0, 0, -21, -22, -126
"/home/sanjay/Desktop/Bitbucket/MarlinV2_morphle/Marlin/src/feature/bedlevel/ubl/ubl.cpp", "C++", 0, -204, 0, 0, 0, -41, -56, -301
"/home/sanjay/Desktop/Bitbucket/MarlinV2_morphle/Marlin/src/feature/bedlevel/ubl/ubl.h", "C++", 0, -193, 0, 0, 0, -65, -59, -317
"/home/sanjay/Desktop/Bitbucket/MarlinV2_morphle/Marlin/src/feature/bedlevel/ubl/ubl_G29.cpp", "C++", 0, -1148, 0, 0, 0, -389, -315, -1852
"/home/sanjay/Desktop/Bitbucket/MarlinV2_morphle/Marlin/src/feature/bedlevel/ubl/ubl_motion.cpp", "C++", 0, -266, 0, 0, 0, -116, -111, -493
"/home/sanjay/Desktop/Bitbucket/MarlinV2_morphle/Marlin/src/feature/binary_stream.cpp", "C++", 0, -9, 0, 0, 0, -21, -7, -37
"/home/sanjay/Desktop/Bitbucket/MarlinV2_morphle/Marlin/src/feature/binary_stream.h", "C++", 0, -376, 0, 0, 0, -36, -45, -457
"/home/sanjay/Desktop/Bitbucket/MarlinV2_morphle/Marlin/src/feature/bltouch.cpp", "C++", 0, -95, 0, 0, 0, -61, -41, -197
"/home/sanjay/Desktop/Bitbucket/MarlinV2_morphle/Marlin/src/feature/bltouch.h", "C++", 0, -66, 0, 0, 0, -32, -21, -119
"/home/sanjay/Desktop/Bitbucket/MarlinV2_morphle/Marlin/src/feature/cancel_object.cpp", "C++", 0, -49, 0, 0, 0, -21, -13, -83
"/home/sanjay/Desktop/Bitbucket/MarlinV2_morphle/Marlin/src/feature/cancel_object.h", "C++", 0, -17, 0, 0, 0, -21, -4, -42
"/home/sanjay/Desktop/Bitbucket/MarlinV2_morphle/Marlin/src/feature/caselight.cpp", "C++", 0, -56, 0, 0, 0, -31, -17, -104
"/home/sanjay/Desktop/Bitbucket/MarlinV2_morphle/Marlin/src/feature/caselight.h", "C++", 0, -28, 0, 0, 0, -21, -9, -58
"/home/sanjay/Desktop/Bitbucket/MarlinV2_morphle/Marlin/src/feature/closedloop.cpp", "C++", 0, -15, 0, 0, 0, -21, -9, -45
"/home/sanjay/Desktop/Bitbucket/MarlinV2_morphle/Marlin/src/feature/closedloop.h", "C++", 0, -8, 0, 0, 0, -21, -4, -33
"/home/sanjay/Desktop/Bitbucket/MarlinV2_morphle/Marlin/src/feature/controllerfan.cpp", "C++", 0, -45, 0, 0, 0, -28, -14, -87
"/home/sanjay/Desktop/Bitbucket/MarlinV2_morphle/Marlin/src/feature/controllerfan.h", "C++", 0, -42, 0, 0, 0, -21, -10, -73
"/home/sanjay/Desktop/Bitbucket/MarlinV2_morphle/Marlin/src/feature/cooler.cpp", "C++", 0, -21, 0, 0, 0, -21, -7, -49
"/home/sanjay/Desktop/Bitbucket/MarlinV2_morphle/Marlin/src/feature/cooler.h", "C++", 0, -66, 0, 0, 0, -28, -16, -110
"/home/sanjay/Desktop/Bitbucket/MarlinV2_morphle/Marlin/src/feature/dac/dac_dac084s085.cpp", "C++", 0, -69, 0, 0, 0, -9, -20, -98
"/home/sanjay/Desktop/Bitbucket/MarlinV2_morphle/Marlin/src/feature/dac/dac_dac084s085.h", "C++", 0, -9, 0, 0, 0, -21, -2, -32
"/home/sanjay/Desktop/Bitbucket/MarlinV2_morphle/Marlin/src/feature/dac/dac_mcp4728.cpp", "C++", 0, -66, 0, 0, 0, -70, -19, -155
"/home/sanjay/Desktop/Bitbucket/MarlinV2_morphle/Marlin/src/feature/dac/dac_mcp4728.h", "C++", 0, -40, 0, 0, 0, -32, -11, -83
"/home/sanjay/Desktop/Bitbucket/MarlinV2_morphle/Marlin/src/feature/dac/stepper_dac.cpp", "C++", 0, -56, 0, 0, 0, -24, -23, -103
"/home/sanjay/Desktop/Bitbucket/MarlinV2_morphle/Marlin/src/feature/dac/stepper_dac.h", "C++", 0, -13, 0, 0, 0, -24, -5, -42
"/home/sanjay/Desktop/Bitbucket/MarlinV2_morphle/Marlin/src/feature/digipot/digipot.h", "C++", 0, -7, 0, 0, 0, -24, -3, -34
"/home/sanjay/Desktop/Bitbucket/MarlinV2_morphle/Marlin/src/feature/digipot/digipot_mcp4018.cpp", "C++", 0, -68, 0, 0, 0, -24, -17, -109
"/home/sanjay/Desktop/Bitbucket/MarlinV2_morphle/Marlin/src/feature/digipot/digipot_mcp4451.cpp", "C++", 0, -61, 0, 0, 0, -28, -15, -104
"/home/sanjay/Desktop/Bitbucket/MarlinV2_morphle/Marlin/src/feature/direct_stepping.cpp", "C++", 0, -187, 0, 0, 0, -26, -52, -265
"/home/sanjay/Desktop/Bitbucket/MarlinV2_morphle/Marlin/src/feature/direct_stepping.h", "C++", 0, -72, 0, 0, 0, -32, -30, -134
"/home/sanjay/Desktop/Bitbucket/MarlinV2_morphle/Marlin/src/feature/e_parser.cpp", "C++", 0, -11, 0, 0, 0, -26, -9, -46
"/home/sanjay/Desktop/Bitbucket/MarlinV2_morphle/Marlin/src/feature/e_parser.h", "C++", 0, -167, 0, 0, 0, -27, -32, -226
"/home/sanjay/Desktop/Bitbucket/MarlinV2_morphle/Marlin/src/feature/easythreed_ui.cpp", "C++", 0, -180, 0, 0, 0, -29, -28, -237
"/home/sanjay/Desktop/Bitbucket/MarlinV2_morphle/Marlin/src/feature/easythreed_ui.h", "C++", 0, -11, 0, 0, 0, -21, -4, -36
"/home/sanjay/Desktop/Bitbucket/MarlinV2_morphle/Marlin/src/feature/encoder_i2c.cpp", "C++", 0, -722, 0, 0, 0, -215, -192, -1129
"/home/sanjay/Desktop/Bitbucket/MarlinV2_morphle/Marlin/src/feature/encoder_i2c.h", "C++", 0, -215, 0, 0, 0, -32, -74, -321
"/home/sanjay/Desktop/Bitbucket/MarlinV2_morphle/Marlin/src/feature/ethernet.cpp", "C++", 0, -116, 0, 0, 0, -23, -37, -176
"/home/sanjay/Desktop/Bitbucket/MarlinV2_morphle/Marlin/src/feature/ethernet.h", "C++", 0, -13, 0, 0, 0, -22, -5, -40
"/home/sanjay/Desktop/Bitbucket/MarlinV2_morphle/Marlin/src/feature/fancheck.cpp", "C++", 0, -158, 0, 0, 0, -28, -22, -208
"/home/sanjay/Desktop/Bitbucket/MarlinV2_morphle/Marlin/src/feature/fancheck.h", "C++", 0, -48, 0, 0, 0, -24, -18, -90
"/home/sanjay/Desktop/Bitbucket/MarlinV2_morphle/Marlin/src/feature/fanmux.cpp", "C++", 0, -23, 0, 0, 0, -25, -8, -56
"/home/sanjay/Desktop/Bitbucket/MarlinV2_morphle/Marlin/src/feature/fanmux.h", "C++", 0, -3, 0, 0, 0, -24, -3, -30
"/home/sanjay/Desktop/Bitbucket/MarlinV2_morphle/Marlin/src/feature/filwidth.cpp", "C++", 0, -21, 0, 0, 0, -21, -8, -50
"/home/sanjay/Desktop/Bitbucket/MarlinV2_morphle/Marlin/src/feature/filwidth.h", "C++", 0, -60, 0, 0, 0, -41, -20, -121
"/home/sanjay/Desktop/Bitbucket/MarlinV2_morphle/Marlin/src/feature/fwretract.cpp", "C++", 0, -125, 0, 0, 0, -101, -44, -270
"/home/sanjay/Desktop/Bitbucket/MarlinV2_morphle/Marlin/src/feature/fwretract.h", "C++", 0, -49, 0, 0, 0, -24, -17, -90
"/home/sanjay/Desktop/Bitbucket/MarlinV2_morphle/Marlin/src/feature/host_actions.cpp", "C++", 0, -149, 0, 0, 0, -29, -27, -205
"/home/sanjay/Desktop/Bitbucket/MarlinV2_morphle/Marlin/src/feature/host_actions.h", "C++", 0, -75, 0, 0, 0, -21, -19, -115
"/home/sanjay/Desktop/Bitbucket/MarlinV2_morphle/Marlin/src/feature/hotend_idle.cpp", "C++", 0, -50, 0, 0, 0, -27, -15, -92
"/home/sanjay/Desktop/Bitbucket/MarlinV2_morphle/Marlin/src/feature/hotend_idle.h", "C++", 0, -13, 0, 0, 0, -21, -4, -38
"/home/sanjay/Desktop/Bitbucket/MarlinV2_morphle/Marlin/src/feature/joystick.cpp", "C++", 0, -119, 0, 0, 0, -37, -29, -185
"/home/sanjay/Desktop/Bitbucket/MarlinV2_morphle/Marlin/src/feature/joystick.h", "C++", 0, -24, 0, 0, 0, -24, -5, -53
"/home/sanjay/Desktop/Bitbucket/MarlinV2_morphle/Marlin/src/feature/leds/blinkm.cpp", "C++", 0, -16, 0, 0, 0, -24, -7, -47
"/home/sanjay/Desktop/Bitbucket/MarlinV2_morphle/Marlin/src/feature/leds/blinkm.h", "C++", 0, -4, 0, 0, 0, -24, -4, -32
"/home/sanjay/Desktop/Bitbucket/MarlinV2_morphle/Marlin/src/feature/leds/leds.cpp", "C++", 0, -144, 0, 0, 0, -32, -44, -220
"/home/sanjay/Desktop/Bitbucket/MarlinV2_morphle/Marlin/src/feature/leds/leds.h", "C++", 0, -148, 0, 0, 0, -31, -38, -217
"/home/sanjay/Desktop/Bitbucket/MarlinV2_morphle/Marlin/src/feature/leds/neopixel.cpp", "C++", 0, -117, 0, 0, 0, -24, -28, -169
"/home/sanjay/Desktop/Bitbucket/MarlinV2_morphle/Marlin/src/feature/leds/neopixel.h", "C++", 0, -109, 0, 0, 0, -40, -39, -188
"/home/sanjay/Desktop/Bitbucket/MarlinV2_morphle/Marlin/src/feature/leds/pca9533.cpp", "C++", 0, -75, 0, 0, 0, -37, -16, -128
"/home/sanjay/Desktop/Bitbucket/MarlinV2_morphle/Marlin/src/feature/leds/pca9533.h", "C++", 0, -22, 0, 0, 0, -30, -8, -60
"/home/sanjay/Desktop/Bitbucket/MarlinV2_morphle/Marlin/src/feature/leds/pca9632.cpp", "C++", 0, -110, 0, 0, 0, -28, -23, -161
"/home/sanjay/Desktop/Bitbucket/MarlinV2_morphle/Marlin/src/feature/leds/pca9632.h", "C++", 0, -8, 0, 0, 0, -25, -5, -38
"/home/sanjay/Desktop/Bitbucket/MarlinV2_morphle/Marlin/src/feature/leds/printer_event_leds.cpp", "C++", 0, -48, 0, 0, 0, -24, -22, -94
"/home/sanjay/Desktop/Bitbucket/MarlinV2_morphle/Marlin/src/feature/leds/printer_event_leds.h", "C++", 0, -48, 0, 0, 0, -24, -15, -87
"/home/sanjay/Desktop/Bitbucket/MarlinV2_morphle/Marlin/src/feature/leds/tempstat.cpp", "C++", 0, -25, 0, 0, 0, -24, -7, -56
"/home/sanjay/Desktop/Bitbucket/MarlinV2_morphle/Marlin/src/feature/leds/tempstat.h", "C++", 0, -2, 0, 0, 0, -24, -3, -29
"/home/sanjay/Desktop/Bitbucket/MarlinV2_morphle/Marlin/src/feature/max7219.cpp", "C++", 0, -541, 0, 0, 0, -71, -87, -699
"/home/sanjay/Desktop/Bitbucket/MarlinV2_morphle/Marlin/src/feature/max7219.h", "C++", 0, -74, 0, 0, 0, -62, -26, -162
"/home/sanjay/Desktop/Bitbucket/MarlinV2_morphle/Marlin/src/feature/meatpack.cpp", "C++", 0, -130, 0, 0, 0, -64, -25, -219
"/home/sanjay/Desktop/Bitbucket/MarlinV2_morphle/Marlin/src/feature/meatpack.h", "C++", 0, -78, 0, 0, 0, -72, -26, -176
"/home/sanjay/Desktop/Bitbucket/MarlinV2_morphle/Marlin/src/feature/mixing.cpp", "C++", 0, -141, 0, 0, 0, -34, -36, -211
"/home/sanjay/Desktop/Bitbucket/MarlinV2_morphle/Marlin/src/feature/mixing.h", "C++", 0, -175, 0, 0, 0, -43, -45, -263
"/home/sanjay/Desktop/Bitbucket/MarlinV2_morphle/Marlin/src/feature/mmu/mmu.cpp", "C++", 0, -19, 0, 0, 0, -21, -7, -47
"/home/sanjay/Desktop/Bitbucket/MarlinV2_morphle/Marlin/src/feature/mmu/mmu.h", "C++", 0, -3, 0, 0, 0, -21, -2, -26
"/home/sanjay/Desktop/Bitbucket/MarlinV2_morphle/Marlin/src/feature/mmu/mmu2-serial-protocol.md", "Markdown", 0, 0, 0, -51, 0, 0, -44, -95
"/home/sanjay/Desktop/Bitbucket/MarlinV2_morphle/Marlin/src/feature/mmu/mmu2.cpp", "C++", 0, -731, 0, 0, 0, -118, -198, -1047
"/home/sanjay/Desktop/Bitbucket/MarlinV2_morphle/Marlin/src/feature/mmu/mmu2.h", "C++", 0, -71, 0, 0, 0, -21, -20, -112
"/home/sanjay/Desktop/Bitbucket/MarlinV2_morphle/Marlin/src/feature/password/password.cpp", "C++", 0, -24, 0, 0, 0, -29, -9, -62
"/home/sanjay/Desktop/Bitbucket/MarlinV2_morphle/Marlin/src/feature/password/password.h", "C++", 0, -27, 0, 0, 0, -21, -10, -58
"/home/sanjay/Desktop/Bitbucket/MarlinV2_morphle/Marlin/src/feature/pause.cpp", "C++", 0, -408, 0, 0, 0, -163, -156, -727
"/home/sanjay/Desktop/Bitbucket/MarlinV2_morphle/Marlin/src/feature/pause.h", "C++", 0, -84, 0, 0, 0, -26, -20, -130
"/home/sanjay/Desktop/Bitbucket/MarlinV2_morphle/Marlin/src/feature/power.cpp", "C++", 0, -147, 0, 0, 0, -51, -55, -253
"/home/sanjay/Desktop/Bitbucket/MarlinV2_morphle/Marlin/src/feature/power.h", "C++", 0, -39, 0, 0, 0, -24, -10, -73
"/home/sanjay/Desktop/Bitbucket/MarlinV2_morphle/Marlin/src/feature/power_monitor.cpp", "C++", 0, -42, 0, 0, 0, -21, -16, -79
"/home/sanjay/Desktop/Bitbucket/MarlinV2_morphle/Marlin/src/feature/power_monitor.h", "C++", 0, -99, 0, 0, 0, -21, -19, -139
"/home/sanjay/Desktop/Bitbucket/MarlinV2_morphle/Marlin/src/feature/powerloss.cpp", "C++", 0, -463, 0, 0, 0, -122, -128, -713
"/home/sanjay/Desktop/Bitbucket/MarlinV2_morphle/Marlin/src/feature/powerloss.h", "C++", 0, -142, 0, 0, 0, -38, -46, -226
"/home/sanjay/Desktop/Bitbucket/MarlinV2_morphle/Marlin/src/feature/probe_temp_comp.cpp", "C++", 0, -186, 0, 0, 0, -34, -38, -258
"/home/sanjay/Desktop/Bitbucket/MarlinV2_morphle/Marlin/src/feature/probe_temp_comp.h", "C++", 0, -66, 0, 0, 0, -35, -16, -117
"/home/sanjay/Desktop/Bitbucket/MarlinV2_morphle/Marlin/src/feature/repeat.cpp", "C++", 0, -48, 0, 0, 0, -22, -13, -83
"/home/sanjay/Desktop/Bitbucket/MarlinV2_morphle/Marlin/src/feature/repeat.h", "C++", 0, -26, 0, 0, 0, -21, -7, -54
"/home/sanjay/Desktop/Bitbucket/MarlinV2_morphle/Marlin/src/feature/runout.cpp", "C++", 0, -94, 0, 0, 0, -30, -24, -148
"/home/sanjay/Desktop/Bitbucket/MarlinV2_morphle/Marlin/src/feature/runout.h", "C++", 0, -295, 0, 0, 0, -59, -60, -414
"/home/sanjay/Desktop/Bitbucket/MarlinV2_morphle/Marlin/src/feature/solenoid.cpp", "C++", 0, -23, 0, 0, 0, -23, -10, -56
"/home/sanjay/Desktop/Bitbucket/MarlinV2_morphle/Marlin/src/feature/solenoid.h", "C++", 0, -4, 0, 0, 0, -21, -2, -27
"/home/sanjay/Desktop/Bitbucket/MarlinV2_morphle/Marlin/src/feature/spindle_laser.cpp", "C++", 0, -113, 0, 0, 0, -47, -22, -182
"/home/sanjay/Desktop/Bitbucket/MarlinV2_morphle/Marlin/src/feature/spindle_laser.h", "C++", 0, -213, 0, 0, 0, -67, -50, -330
"/home/sanjay/Desktop/Bitbucket/MarlinV2_morphle/Marlin/src/feature/spindle_laser_types.h", "C++", 0, -50, 0, 0, 0, -25, -9, -84
"/home/sanjay/Desktop/Bitbucket/MarlinV2_morphle/Marlin/src/feature/stepper_driver_safety.cpp", "C++", 0, -73, 0, 0, 0, -21, -24, -118
"/home/sanjay/Desktop/Bitbucket/MarlinV2_morphle/Marlin/src/feature/stepper_driver_safety.h", "C++", 0, -4, 0, 0, 0, -21, -4, -29
"/home/sanjay/Desktop/Bitbucket/MarlinV2_morphle/Marlin/src/feature/tmc_util.cpp", "C++", 0, -1176, 0, 0, 0, -43, -118, -1337
"/home/sanjay/Desktop/Bitbucket/MarlinV2_morphle/Marlin/src/feature/tmc_util.h", "C++", 0, -301, 0, 0, 0, -31, -58, -390
"/home/sanjay/Desktop/Bitbucket/MarlinV2_morphle/Marlin/src/feature/tramming.cpp", "C++", 0, -37, 0, 0, 0, -22, -11, -70
"/home/sanjay/Desktop/Bitbucket/MarlinV2_morphle/Marlin/src/feature/tramming.h", "C++", 0, -48, 0, 0, 0, -21, -10, -79
"/home/sanjay/Desktop/Bitbucket/MarlinV2_morphle/Marlin/src/feature/twibus.cpp", "C++", 0, -150, 0, 0, 0, -32, -56, -238
"/home/sanjay/Desktop/Bitbucket/MarlinV2_morphle/Marlin/src/feature/twibus.h", "C++", 0, -50, 0, 0, 0, -170, -35, -255
"/home/sanjay/Desktop/Bitbucket/MarlinV2_morphle/Marlin/src/feature/x_twist.cpp", "C++", 0, -37, 0, 0, 0, -21, -10, -68
"/home/sanjay/Desktop/Bitbucket/MarlinV2_morphle/Marlin/src/feature/x_twist.h", "C++", 0, -14, 0, 0, 0, -21, -6, -41
"/home/sanjay/Desktop/Bitbucket/MarlinV2_morphle/Marlin/src/feature/z_stepper_align.cpp", "C++", 0, -81, 0, 0, 0, -24, -17, -122
"/home/sanjay/Desktop/Bitbucket/MarlinV2_morphle/Marlin/src/feature/z_stepper_align.h", "C++", 0, -11, 0, 0, 0, -24, -7, -42
"/home/sanjay/Desktop/Bitbucket/MarlinV2_morphle/Marlin/src/inc/Conditionals_LCD.h", "C++", 0, -1119, 0, 0, 0, -195, -175, -1489
"/home/sanjay/Desktop/Bitbucket/MarlinV2_morphle/Marlin/src/inc/Conditionals_adv.h", "C++", 0, -877, 0, 0, 0, -71, -87, -1035
"/home/sanjay/Desktop/Bitbucket/MarlinV2_morphle/Marlin/src/inc/Conditionals_post.h", "C++", 0, -3069, 0, 0, 0, -254, -204, -3527
"/home/sanjay/Desktop/Bitbucket/MarlinV2_morphle/Marlin/src/inc/MarlinConfig.h", "C++", 0, -21, 0, 0, 0, -25, -14, -60
"/home/sanjay/Desktop/Bitbucket/MarlinV2_morphle/Marlin/src/inc/MarlinConfigPre.h", "C++", 0, -27, 0, 0, 0, -24, -12, -63
"/home/sanjay/Desktop/Bitbucket/MarlinV2_morphle/Marlin/src/inc/SanityCheck.h", "C++", 0, -3258, 0, 0, 0, -444, -279, -3981
"/home/sanjay/Desktop/Bitbucket/MarlinV2_morphle/Marlin/src/inc/Version.h", "C++", 0, -47, 0, 0, 0, -64, -12, -123
"/home/sanjay/Desktop/Bitbucket/MarlinV2_morphle/Marlin/src/inc/Warnings.cpp", "C++", 0, -550, 0, 0, 0, -42, -27, -619
"/home/sanjay/Desktop/Bitbucket/MarlinV2_morphle/Marlin/src/lcd/HD44780/lcdprint_hd44780.cpp", "C++", 0, -863, 0, 0, 0, -178, -104, -1145
"/home/sanjay/Desktop/Bitbucket/MarlinV2_morphle/Marlin/src/lcd/HD44780/marlinui_HD44780.cpp", "C++", 0, -1097, 0, 0, 0, -227, -272, -1596
"/home/sanjay/Desktop/Bitbucket/MarlinV2_morphle/Marlin/src/lcd/HD44780/marlinui_HD44780.h", "C++", 0, -51, 0, 0, 0, -31, -26, -108
"/home/sanjay/Desktop/Bitbucket/MarlinV2_morphle/Marlin/src/lcd/TFTGLCD/lcdprint_TFTGLCD.cpp", "C++", 0, -873, 0, 0, 0, -170, -100, -1143
"/home/sanjay/Desktop/Bitbucket/MarlinV2_morphle/Marlin/src/lcd/TFTGLCD/marlinui_TFTGLCD.cpp", "C++", 0, -768, 0, 0, 0, -169, -158, -1095
"/home/sanjay/Desktop/Bitbucket/MarlinV2_morphle/Marlin/src/lcd/TFTGLCD/marlinui_TFTGLCD.h", "C++", 0, -28, 0, 0, 0, -33, -12, -73
"/home/sanjay/Desktop/Bitbucket/MarlinV2_morphle/Marlin/src/lcd/buttons.h", "C++", 0, -171, 0, 0, 0, -27, -29, -227
"/home/sanjay/Desktop/Bitbucket/MarlinV2_morphle/Marlin/src/lcd/dogm/HAL_LCD_class_defines.h", "C++", 0, -87, 0, 0, 0, -30, -20, -137
"/home/sanjay/Desktop/Bitbucket/MarlinV2_morphle/Marlin/src/lcd/dogm/HAL_LCD_com_defines.h", "C++", 0, -86, 0, 0, 0, -23, -24, -133
"/home/sanjay/Desktop/Bitbucket/MarlinV2_morphle/Marlin/src/lcd/dogm/dogm_Bootscreen.h", "C++", 0, -479, 0, 0, 0, -27, -35, -541
"/home/sanjay/Desktop/Bitbucket/MarlinV2_morphle/Marlin/src/lcd/dogm/dogm_Statusscreen.h", "C++", 0, -583, 0, 0, 0, -100, -83, -766
"/home/sanjay/Desktop/Bitbucket/MarlinV2_morphle/Marlin/src/lcd/dogm/fontdata/fontdata_6x9_marlin.h", "C++", 0, -156, 0, 0, 0, -32, -2, -190
"/home/sanjay/Desktop/Bitbucket/MarlinV2_morphle/Marlin/src/lcd/dogm/fontdata/fontdata_ISO10646_1.h", "C++", 0, -255, 0, 0, 0, -45, -6, -306
"/home/sanjay/Desktop/Bitbucket/MarlinV2_morphle/Marlin/src/lcd/dogm/fontdata/langdata.h", "C++", 0, -3, 0, 0, 0, -18, -3, -24
"/home/sanjay/Desktop/Bitbucket/MarlinV2_morphle/Marlin/src/lcd/dogm/fontdata/langdata_an.h", "C++", 0, -3, 0, 0, 0, -5, -3, -11
"/home/sanjay/Desktop/Bitbucket/MarlinV2_morphle/Marlin/src/lcd/dogm/fontdata/langdata_bg.h", "C++", 0, -70, 0, 0, 0, -5, -4, -79
"/home/sanjay/Desktop/Bitbucket/MarlinV2_morphle/Marlin/src/lcd/dogm/fontdata/langdata_ca.h", "C++", 0, -3, 0, 0, 0, -5, -3, -11
"/home/sanjay/Desktop/Bitbucket/MarlinV2_morphle/Marlin/src/lcd/dogm/fontdata/langdata_cz.h", "C++", 0, -47, 0, 0, 0, -5, -4, -56
"/home/sanjay/Desktop/Bitbucket/MarlinV2_morphle/Marlin/src/lcd/dogm/fontdata/langdata_da.h", "C++", 0, -3, 0, 0, 0, -5, -3, -11
"/home/sanjay/Desktop/Bitbucket/MarlinV2_morphle/Marlin/src/lcd/dogm/fontdata/langdata_de.h", "C++", 0, -3, 0, 0, 0, -5, -3, -11
"/home/sanjay/Desktop/Bitbucket/MarlinV2_morphle/Marlin/src/lcd/dogm/fontdata/langdata_el.h", "C++", 0, -83, 0, 0, 0, -5, -4, -92
"/home/sanjay/Desktop/Bitbucket/MarlinV2_morphle/Marlin/src/lcd/dogm/fontdata/langdata_el_CY.h", "C++", 0, -83, 0, 0, 0, -5, -4, -92
"/home/sanjay/Desktop/Bitbucket/MarlinV2_morphle/Marlin/src/lcd/dogm/fontdata/langdata_en.h", "C++", 0, -3, 0, 0, 0, -5, -3, -11
"/home/sanjay/Desktop/Bitbucket/MarlinV2_morphle/Marlin/src/lcd/dogm/fontdata/langdata_es.h", "C++", 0, -3, 0, 0, 0, -5, -3, -11
"/home/sanjay/Desktop/Bitbucket/MarlinV2_morphle/Marlin/src/lcd/dogm/fontdata/langdata_eu.h", "C++", 0, -3, 0, 0, 0, -5, -3, -11
"/home/sanjay/Desktop/Bitbucket/MarlinV2_morphle/Marlin/src/lcd/dogm/fontdata/langdata_fi.h", "C++", 0, -3, 0, 0, 0, -5, -3, -11
"/home/sanjay/Desktop/Bitbucket/MarlinV2_morphle/Marlin/src/lcd/dogm/fontdata/langdata_fr.h", "C++", 0, -3, 0, 0, 0, -5, -3, -11
"/home/sanjay/Desktop/Bitbucket/MarlinV2_morphle/Marlin/src/lcd/dogm/fontdata/langdata_gl.h", "C++", 0, -3, 0, 0, 0, -5, -3, -11
"/home/sanjay/Desktop/Bitbucket/MarlinV2_morphle/Marlin/src/lcd/dogm/fontdata/langdata_hr.h", "C++", 0, -25, 0, 0, 0, -5, -4, -34
"/home/sanjay/Desktop/Bitbucket/MarlinV2_morphle/Marlin/src/lcd/dogm/fontdata/langdata_hu.h", "C++", 0, -8, 0, 0, 0, -5, -4, -17
"/home/sanjay/Desktop/Bitbucket/MarlinV2_morphle/Marlin/src/lcd/dogm/fontdata/langdata_it.h", "C++", 0, -3, 0, 0, 0, -5, -3, -11
"/home/sanjay/Desktop/Bitbucket/MarlinV2_morphle/Marlin/src/lcd/dogm/fontdata/langdata_jp_kana.h", "C++", 0, -104, 0, 0, 0, -5, -4, -113
"/home/sanjay/Desktop/Bitbucket/MarlinV2_morphle/Marlin/src/lcd/dogm/fontdata/langdata_ko_KR.h", "C++", 0, -540, 0, 0, 0, -5, -4, -549
"/home/sanjay/Desktop/Bitbucket/MarlinV2_morphle/Marlin/src/lcd/dogm/fontdata/langdata_nl.h", "C++", 0, -3, 0, 0, 0, -5, -3, -11
"/home/sanjay/Desktop/Bitbucket/MarlinV2_morphle/Marlin/src/lcd/dogm/fontdata/langdata_pl.h", "C++", 0, -33, 0, 0, 0, -5, -4, -42
"/home/sanjay/Desktop/Bitbucket/MarlinV2_morphle/Marlin/src/lcd/dogm/fontdata/langdata_pt.h", "C++", 0, -3, 0, 0, 0, -5, -3, -11
"/home/sanjay/Desktop/Bitbucket/MarlinV2_morphle/Marlin/src/lcd/dogm/fontdata/langdata_pt_br.h", "C++", 0, -3, 0, 0, 0, -5, -3, -11
"/home/sanjay/Desktop/Bitbucket/MarlinV2_morphle/Marlin/src/lcd/dogm/fontdata/langdata_ro.h", "C++", 0, -3, 0, 0, 0, -5, -3, -11
"/home/sanjay/Desktop/Bitbucket/MarlinV2_morphle/Marlin/src/lcd/dogm/fontdata/langdata_ru.h", "C++", 0, -66, 0, 0, 0, -5, -4, -75
"/home/sanjay/Desktop/Bitbucket/MarlinV2_morphle/Marlin/src/lcd/dogm/fontdata/langdata_sk.h", "C++", 0, -42, 0, 0, 0, -5, -4, -51
"/home/sanjay/Desktop/Bitbucket/MarlinV2_morphle/Marlin/src/lcd/dogm/fontdata/langdata_test.h", "C++", 0, -224, 0, 0, 0, -5, -4, -233
"/home/sanjay/Desktop/Bitbucket/MarlinV2_morphle/Marlin/src/lcd/dogm/fontdata/langdata_tr.h", "C++", 0, -20, 0, 0, 0, -5, -4, -29
"/home/sanjay/Desktop/Bitbucket/MarlinV2_morphle/Marlin/src/lcd/dogm/fontdata/langdata_uk.h", "C++", 0, -78, 0, 0, 0, -5, -4, -87
"/home/sanjay/Desktop/Bitbucket/MarlinV2_morphle/Marlin/src/lcd/dogm/fontdata/langdata_vi.h", "C++", 0, -220, 0, 0, 0, -5, -4, -229
"/home/sanjay/Desktop/Bitbucket/MarlinV2_morphle/Marlin/src/lcd/dogm/fontdata/langdata_zh_CN.h", "C++", 0, -1816, 0, 0, 0, -5, -4, -1825
"/home/sanjay/Desktop/Bitbucket/MarlinV2_morphle/Marlin/src/lcd/dogm/fontdata/langdata_zh_TW.h", "C++", 0, -1514, 0, 0, 0, -5, -4, -1523
"/home/sanjay/Desktop/Bitbucket/MarlinV2_morphle/Marlin/src/lcd/dogm/lcdprint_u8g.cpp", "C++", 0, -34, 0, 0, 0, -10, -13, -57
"/home/sanjay/Desktop/Bitbucket/MarlinV2_morphle/Marlin/src/lcd/dogm/marlinui_DOGM.cpp", "C++", 0, -558, 0, 0, 0, -79, -118, -755
"/home/sanjay/Desktop/Bitbucket/MarlinV2_morphle/Marlin/src/lcd/dogm/marlinui_DOGM.h", "C++", 0, -123, 0, 0, 0, -50, -62, -235
"/home/sanjay/Desktop/Bitbucket/MarlinV2_morphle/Marlin/src/lcd/dogm/status/ammeter.h", "C++", 0, -40, 0, 0, 0, -24, -5, -69
"/home/sanjay/Desktop/Bitbucket/MarlinV2_morphle/Marlin/src/lcd/dogm/status/bed.h", "C++", 0, -96, 0, 0, 0, -24, -19, -139
"/home/sanjay/Desktop/Bitbucket/MarlinV2_morphle/Marlin/src/lcd/dogm/status/chamber.h", "C++", 0, -58, 0, 0, 0, -24, -8, -90
"/home/sanjay/Desktop/Bitbucket/MarlinV2_morphle/Marlin/src/lcd/dogm/status/combined.h", "C++", 0, -248, 0, 0, 0, -27, -41, -316
"/home/sanjay/Desktop/Bitbucket/MarlinV2_morphle/Marlin/src/lcd/dogm/status/cooler.h", "C++", 0, -87, 0, 0, 0, -24, -9, -120
"/home/sanjay/Desktop/Bitbucket/MarlinV2_morphle/Marlin/src/lcd/dogm/status/cutter.h", "C++", 0, -96, 0, 0, 0, -24, -4, -124
"/home/sanjay/Desktop/Bitbucket/MarlinV2_morphle/Marlin/src/lcd/dogm/status/fan.h", "C++", 0, -395, 0, 0, 0, -24, -25, -444
"/home/sanjay/Desktop/Bitbucket/MarlinV2_morphle/Marlin/src/lcd/dogm/status/hotend.h", "C++", 0, -668, 0, 0, 0, -24, -68, -760
"/home/sanjay/Desktop/Bitbucket/MarlinV2_morphle/Marlin/src/lcd/dogm/status_screen_DOGM.cpp", "C++", 0, -759, 0, 0, 0, -105, -168, -1032
"/home/sanjay/Desktop/Bitbucket/MarlinV2_morphle/Marlin/src/lcd/dogm/status_screen_lite_ST7920.cpp", "C++", 0, -702, 0, 0, 0, -107, -112, -921
"/home/sanjay/Desktop/Bitbucket/MarlinV2_morphle/Marlin/src/lcd/dogm/status_screen_lite_ST7920.h", "C++", 0, -76, 0, 0, 0, -14, -17, -107
"/home/sanjay/Desktop/Bitbucket/MarlinV2_morphle/Marlin/src/lcd/dogm/u8g_dev_ssd1306_sh1106_128x64_I2C.cpp", "C++", 0, -205, 0, 0, 0, -72, -26, -303
"/home/sanjay/Desktop/Bitbucket/MarlinV2_morphle/Marlin/src/lcd/dogm/u8g_dev_ssd1309_12864.cpp", "C++", 0, -93, 0, 0, 0, -23, -14, -130
"/home/sanjay/Desktop/Bitbucket/MarlinV2_morphle/Marlin/src/lcd/dogm/u8g_dev_st7565_64128n_HAL.cpp", "C++", 0, -155, 0, 0, 0, -56, -31, -242
"/home/sanjay/Desktop/Bitbucket/MarlinV2_morphle/Marlin/src/lcd/dogm/u8g_dev_st7920_128x64_HAL.cpp", "C++", 0, -126, 0, 0, 0, -56, -27, -209
"/home/sanjay/Desktop/Bitbucket/MarlinV2_morphle/Marlin/src/lcd/dogm/u8g_dev_tft_upscale_from_128x64.cpp", "C++", 0, -422, 0, 0, 0, -64, -74, -560
"/home/sanjay/Desktop/Bitbucket/MarlinV2_morphle/Marlin/src/lcd/dogm/u8g_dev_uc1701_mini12864_HAL.cpp", "C++", 0, -137, 0, 0, 0, -53, -24, -214
"/home/sanjay/Desktop/Bitbucket/MarlinV2_morphle/Marlin/src/lcd/dogm/u8g_fontutf8.cpp", "C++", 0, -174, 0, 0, 0, -98, -44, -316
"/home/sanjay/Desktop/Bitbucket/MarlinV2_morphle/Marlin/src/lcd/dogm/u8g_fontutf8.h", "C++", 0, -20, 0, 0, 0, -11, -10, -41
"/home/sanjay/Desktop/Bitbucket/MarlinV2_morphle/Marlin/src/lcd/dogm/ultralcd_st7920_u8glib_rrd_AVR.cpp", "C++", 0, -150, 0, 0, 0, -25, -22, -197
"/home/sanjay/Desktop/Bitbucket/MarlinV2_morphle/Marlin/src/lcd/dogm/ultralcd_st7920_u8glib_rrd_AVR.h", "C++", 0, -20, 0, 0, 0, -25, -9, -54
"/home/sanjay/Desktop/Bitbucket/MarlinV2_morphle/Marlin/src/lcd/e3v2/README.md", "Markdown", 0, 0, 0, -4, 0, 0, -4, -8
"/home/sanjay/Desktop/Bitbucket/MarlinV2_morphle/Marlin/src/lcd/e3v2/common/dwin_api.cpp", "C++", 0, -264, 0, 0, 0, -167, -41, -472
"/home/sanjay/Desktop/Bitbucket/MarlinV2_morphle/Marlin/src/lcd/e3v2/common/dwin_api.h", "C++", 0, -91, 0, 0, 0, -136, -44, -271
"/home/sanjay/Desktop/Bitbucket/MarlinV2_morphle/Marlin/src/lcd/e3v2/common/dwin_color.h", "C++", 0, -20, 0, 0, 0, -22, -3, -45
"/home/sanjay/Desktop/Bitbucket/MarlinV2_morphle/Marlin/src/lcd/e3v2/common/dwin_font.h", "C++", 0, -12, 0, 0, 0, -26, -3, -41
"/home/sanjay/Desktop/Bitbucket/MarlinV2_morphle/Marlin/src/lcd/e3v2/common/dwin_set.h", "C++", 0, -114, 0, 0, 0, -23, -11, -148
"/home/sanjay/Desktop/Bitbucket/MarlinV2_morphle/Marlin/src/lcd/e3v2/common/encoder.cpp", "C++", 0, -177, 0, 0, 0, -44, -33, -254
"/home/sanjay/Desktop/Bitbucket/MarlinV2_morphle/Marlin/src/lcd/e3v2/common/encoder.h", "C++", 0, -50, 0, 0, 0, -39, -23, -112
"/home/sanjay/Desktop/Bitbucket/MarlinV2_morphle/Marlin/src/lcd/e3v2/creality/dwin.cpp", "C++", 0, -3623, 0, 0, 0, -223, -472, -4318
"/home/sanjay/Desktop/Bitbucket/MarlinV2_morphle/Marlin/src/lcd/e3v2/creality/dwin.h", "C++", 0, -181, 0, 0, 0, -35, -34, -250
"/home/sanjay/Desktop/Bitbucket/MarlinV2_morphle/Marlin/src/lcd/e3v2/creality/dwin_lcd.cpp", "C++", 0, -32, 0, 0, 0, -40, -13, -85
"/home/sanjay/Desktop/Bitbucket/MarlinV2_morphle/Marlin/src/lcd/e3v2/creality/dwin_lcd.h", "C++", 0, -10, 0, 0, 0, -33, -5, -48
"/home/sanjay/Desktop/Bitbucket/MarlinV2_morphle/Marlin/src/lcd/e3v2/jyersui/README.md", "Markdown", 0, 0, 0, -4, 0, 0, -4, -8
"/home/sanjay/Desktop/Bitbucket/MarlinV2_morphle/Marlin/src/lcd/e3v2/jyersui/dwin.cpp", "C++", 0, -4488, 0, 0, 0, -45, -316, -4849
"/home/sanjay/Desktop/Bitbucket/MarlinV2_morphle/Marlin/src/lcd/e3v2/jyersui/dwin.h", "C++", 0, -197, 0, 0, 0, -27, -22, -246
"/home/sanjay/Desktop/Bitbucket/MarlinV2_morphle/Marlin/src/lcd/e3v2/jyersui/dwin_lcd.cpp", "C++", 0, -18, 0, 0, 0, -35, -12, -65
"/home/sanjay/Desktop/Bitbucket/MarlinV2_morphle/Marlin/src/lcd/e3v2/jyersui/dwin_lcd.h", "C++", 0, -3, 0, 0, 0, -28, -4, -35
"/home/sanjay/Desktop/Bitbucket/MarlinV2_morphle/Marlin/src/lcd/e3v2/marlinui/dwin_lcd.cpp", "C++", 0, -20, 0, 0, 0, -32, -12, -64
"/home/sanjay/Desktop/Bitbucket/MarlinV2_morphle/Marlin/src/lcd/e3v2/marlinui/dwin_lcd.h", "C++", 0, -38, 0, 0, 0, -32, -13, -83
"/home/sanjay/Desktop/Bitbucket/MarlinV2_morphle/Marlin/src/lcd/e3v2/marlinui/dwin_string.cpp", "C++", 0, -120, 0, 0, 0, -42, -21, -183
"/home/sanjay/Desktop/Bitbucket/MarlinV2_morphle/Marlin/src/lcd/e3v2/marlinui/dwin_string.h", "C++", 0, -767, 0, 0, 0, -192, -92, -1051
"/home/sanjay/Desktop/Bitbucket/MarlinV2_morphle/Marlin/src/lcd/e3v2/marlinui/lcdprint_dwin.cpp", "C++", 0, -117, 0, 0, 0, -45, -29, -191
"/home/sanjay/Desktop/Bitbucket/MarlinV2_morphle/Marlin/src/lcd/e3v2/marlinui/lcdprint_dwin.h", "C++", 0, -6, 0, 0, 0, -21, -4, -31
"/home/sanjay/Desktop/Bitbucket/MarlinV2_morphle/Marlin/src/lcd/e3v2/marlinui/marlinui_dwin.h", "C++", 0, -104, 0, 0, 0, -29, -14, -147
"/home/sanjay/Desktop/Bitbucket/MarlinV2_morphle/Marlin/src/lcd/e3v2/marlinui/ui_common.cpp", "C++", 0, -406, 0, 0, 0, -75, -114, -595
"/home/sanjay/Desktop/Bitbucket/MarlinV2_morphle/Marlin/src/lcd/e3v2/marlinui/ui_status_480x272.cpp", "C++", 0, -342, 0, 0, 0, -63, -70, -475
"/home/sanjay/Desktop/Bitbucket/MarlinV2_morphle/Marlin/src/lcd/e3v2/proui/base64.hpp", "C++", 0, -95, 0, 0, 0, -77, -37, -209
"/home/sanjay/Desktop/Bitbucket/MarlinV2_morphle/Marlin/src/lcd/e3v2/proui/bedlevel_tools.cpp", "C++", 0, -218, 0, 0, 0, -33, -36, -287
"/home/sanjay/Desktop/Bitbucket/MarlinV2_morphle/Marlin/src/lcd/e3v2/proui/bedlevel_tools.h", "C++", 0, -37, 0, 0, 0, -31, -10, -78
"/home/sanjay/Desktop/Bitbucket/MarlinV2_morphle/Marlin/src/lcd/e3v2/proui/dwin.cpp", "C++", 0, -3266, 0, 0, 0, -156, -454, -3876
"/home/sanjay/Desktop/Bitbucket/MarlinV2_morphle/Marlin/src/lcd/e3v2/proui/dwin.h", "C++", 0, -245, 0, 0, 0, -33, -16, -294
"/home/sanjay/Desktop/Bitbucket/MarlinV2_morphle/Marlin/src/lcd/e3v2/proui/dwin_defines.h", "C++", 0, -83, 0, 0, 0, -32, -8, -123
"/home/sanjay/Desktop/Bitbucket/MarlinV2_morphle/Marlin/src/lcd/e3v2/proui/dwin_lcd.cpp", "C++", 0, -72, 0, 0, 0, -71, -18, -161
"/home/sanjay/Desktop/Bitbucket/MarlinV2_morphle/Marlin/src/lcd/e3v2/proui/dwin_lcd.h", "C++", 0, -11, 0, 0, 0, -56, -10, -77
"/home/sanjay/Desktop/Bitbucket/MarlinV2_morphle/Marlin/src/lcd/e3v2/proui/dwin_popup.cpp", "C++", 0, -55, 0, 0, 0, -27, -14, -96
"/home/sanjay/Desktop/Bitbucket/MarlinV2_morphle/Marlin/src/lcd/e3v2/proui/dwin_popup.h", "C++", 0, -37, 0, 0, 0, -27, -10, -74
"/home/sanjay/Desktop/Bitbucket/MarlinV2_morphle/Marlin/src/lcd/e3v2/proui/dwinui.cpp", "C++", 0, -229, 0, 0, 0, -101, -43, -373
"/home/sanjay/Desktop/Bitbucket/MarlinV2_morphle/Marlin/src/lcd/e3v2/proui/dwinui.h", "C++", 0, -362, 0, 0, 0, -148, -53, -563
"/home/sanjay/Desktop/Bitbucket/MarlinV2_morphle/Marlin/src/lcd/e3v2/proui/endstop_diag.cpp", "C++", 0, -71, 0, 0, 0, -27, -16, -114
"/home/sanjay/Desktop/Bitbucket/MarlinV2_morphle/Marlin/src/lcd/e3v2/proui/endstop_diag.h", "C++", 0, -7, 0, 0, 0, -27, -4, -38
"/home/sanjay/Desktop/Bitbucket/MarlinV2_morphle/Marlin/src/lcd/e3v2/proui/gcode_preview.cpp", "C++", 0, -190, 0, 0, 0, -44, -25, -259
"/home/sanjay/Desktop/Bitbucket/MarlinV2_morphle/Marlin/src/lcd/e3v2/proui/gcode_preview.h", "C++", 0, -4, 0, 0, 0, -21, -3, -28
"/home/sanjay/Desktop/Bitbucket/MarlinV2_morphle/Marlin/src/lcd/e3v2/proui/lockscreen.cpp", "C++", 0, -40, 0, 0, 0, -27, -14, -81
"/home/sanjay/Desktop/Bitbucket/MarlinV2_morphle/Marlin/src/lcd/e3v2/proui/lockscreen.h", "C++", 0, -15, 0, 0, 0, -27, -5, -47
"/home/sanjay/Desktop/Bitbucket/MarlinV2_morphle/Marlin/src/lcd/e3v2/proui/menus.cpp", "C++", 0, -375, 0, 0, 0, -121, -71, -567
"/home/sanjay/Desktop/Bitbucket/MarlinV2_morphle/Marlin/src/lcd/e3v2/proui/menus.h", "C++", 0, -110, 0, 0, 0, -55, -24, -189
"/home/sanjay/Desktop/Bitbucket/MarlinV2_morphle/Marlin/src/lcd/e3v2/proui/meshviewer.cpp", "C++", 0, -106, 0, 0, 0, -27, -12, -145
"/home/sanjay/Desktop/Bitbucket/MarlinV2_morphle/Marlin/src/lcd/e3v2/proui/meshviewer.h", "C++", 0, -9, 0, 0, 0, -27, -5, -41
"/home/sanjay/Desktop/Bitbucket/MarlinV2_morphle/Marlin/src/lcd/e3v2/proui/plot.cpp", "C++", 0, -43, 0, 0, 0, -42, -15, -100
"/home/sanjay/Desktop/Bitbucket/MarlinV2_morphle/Marlin/src/lcd/e3v2/proui/plot.h", "C++", 0, -8, 0, 0, 0, -42, -5, -55
"/home/sanjay/Desktop/Bitbucket/MarlinV2_morphle/Marlin/src/lcd/e3v2/proui/printstats.cpp", "C++", 0, -43, 0, 0, 0, -27, -13, -83
"/home/sanjay/Desktop/Bitbucket/MarlinV2_morphle/Marlin/src/lcd/e3v2/proui/printstats.h", "C++", 0, -8, 0, 0, 0, -27, -5, -40
"/home/sanjay/Desktop/Bitbucket/MarlinV2_morphle/Marlin/src/lcd/extui/anycubic_chiron/FileNavigator.cpp", "C++", 0, -170, 0, 0, 0, -57, -32, -259
"/home/sanjay/Desktop/Bitbucket/MarlinV2_morphle/Marlin/src/lcd/extui/anycubic_chiron/FileNavigator.h", "C++", 0, -25, 0, 0, 0, -28, -9, -62
"/home/sanjay/Desktop/Bitbucket/MarlinV2_morphle/Marlin/src/lcd/extui/anycubic_chiron/Tunes.cpp", "C++", 0, -18, 0, 0, 0, -33, -11, -62
"/home/sanjay/Desktop/Bitbucket/MarlinV2_morphle/Marlin/src/lcd/extui/anycubic_chiron/Tunes.h", "C++", 0, -161, 0, 0, 0, -45, -19, -225
"/home/sanjay/Desktop/Bitbucket/MarlinV2_morphle/Marlin/src/lcd/extui/anycubic_chiron/chiron_extui.cpp", "C++", 0, -58, 0, 0, 0, -49, -31, -138
"/home/sanjay/Desktop/Bitbucket/MarlinV2_morphle/Marlin/src/lcd/extui/anycubic_chiron/chiron_tft.cpp", "C++", 0, -776, 0, 0, 0, -102, -108, -986
"/home/sanjay/Desktop/Bitbucket/MarlinV2_morphle/Marlin/src/lcd/extui/anycubic_chiron/chiron_tft.h", "C++", 0, -54, 0, 0, 0, -28, -8, -90
"/home/sanjay/Desktop/Bitbucket/MarlinV2_morphle/Marlin/src/lcd/extui/anycubic_chiron/chiron_tft_defs.h", "C++", 0, -138, 0, 0, 0, -32, -13, -183
"/home/sanjay/Desktop/Bitbucket/MarlinV2_morphle/Marlin/src/lcd/extui/anycubic_i3mega/anycubic_extui.cpp", "C++", 0, -55, 0, 0, 0, -45, -25, -125
"/home/sanjay/Desktop/Bitbucket/MarlinV2_morphle/Marlin/src/lcd/extui/anycubic_i3mega/anycubic_i3mega_lcd.cpp", "C++", 0, -826, 0, 0, 0, -62, -139, -1027
"/home/sanjay/Desktop/Bitbucket/MarlinV2_morphle/Marlin/src/lcd/extui/anycubic_i3mega/anycubic_i3mega_lcd.h", "C++", 0, -66, 0, 0, 0, -20, -10, -96
"/home/sanjay/Desktop/Bitbucket/MarlinV2_morphle/Marlin/src/lcd/extui/dgus/DGUSDisplay.cpp", "C++", 0, -180, 0, 0, 0, -48, -44, -272
"/home/sanjay/Desktop/Bitbucket/MarlinV2_morphle/Marlin/src/lcd/extui/dgus/DGUSDisplay.h", "C++", 0, -55, 0, 0, 0, -43, -28, -126
"/home/sanjay/Desktop/Bitbucket/MarlinV2_morphle/Marlin/src/lcd/extui/dgus/DGUSDisplayDef.h", "C++", 0, -19, 0, 0, 0, -30, -9, -58
"/home/sanjay/Desktop/Bitbucket/MarlinV2_morphle/Marlin/src/lcd/extui/dgus/DGUSScreenHandler.cpp", "C++", 0, -577, 0, 0, 0, -61, -101, -739
"/home/sanjay/Desktop/Bitbucket/MarlinV2_morphle/Marlin/src/lcd/extui/dgus/DGUSScreenHandler.h", "C++", 0, -36, 0, 0, 0, -26, -12, -74
"/home/sanjay/Desktop/Bitbucket/MarlinV2_morphle/Marlin/src/lcd/extui/dgus/DGUSScreenHandlerBase.h", "C++", 0, -138, 0, 0, 0, -72, -32, -242
"/home/sanjay/Desktop/Bitbucket/MarlinV2_morphle/Marlin/src/lcd/extui/dgus/DGUSVPVariable.h", "C++", 0, -14, 0, 0, 0, -30, -6, -50
"/home/sanjay/Desktop/Bitbucket/MarlinV2_morphle/Marlin/src/lcd/extui/dgus/dgus_extui.cpp", "C++", 0, -90, 0, 0, 0, -45, -29, -164
"/home/sanjay/Desktop/Bitbucket/MarlinV2_morphle/Marlin/src/lcd/extui/dgus/fysetc/DGUSDisplayDef.cpp", "C++", 0, -395, 0, 0, 0, -35, -49, -479
"/home/sanjay/Desktop/Bitbucket/MarlinV2_morphle/Marlin/src/lcd/extui/dgus/fysetc/DGUSDisplayDef.h", "C++", 0, -146, 0, 0, 0, -106, -45, -297
"/home/sanjay/Desktop/Bitbucket/MarlinV2_morphle/Marlin/src/lcd/extui/dgus/fysetc/DGUSScreenHandler.cpp", "C++", 0, -320, 0, 0, 0, -44, -60, -424
"/home/sanjay/Desktop/Bitbucket/MarlinV2_morphle/Marlin/src/lcd/extui/dgus/fysetc/DGUSScreenHandler.h", "C++", 0, -7, 0, 0, 0, -21, -4, -32
"/home/sanjay/Desktop/Bitbucket/MarlinV2_morphle/Marlin/src/lcd/extui/dgus/hiprecy/DGUSDisplayDef.cpp", "C++", 0, -388, 0, 0, 0, -35, -49, -472
"/home/sanjay/Desktop/Bitbucket/MarlinV2_morphle/Marlin/src/lcd/extui/dgus/hiprecy/DGUSDisplayDef.h", "C++", 0, -133, 0, 0, 0, -115, -45, -293
"/home/sanjay/Desktop/Bitbucket/MarlinV2_morphle/Marlin/src/lcd/extui/dgus/hiprecy/DGUSScreenHandler.cpp", "C++", 0, -320, 0, 0, 0, -44, -60, -424
"/home/sanjay/Desktop/Bitbucket/MarlinV2_morphle/Marlin/src/lcd/extui/dgus/hiprecy/DGUSScreenHandler.h", "C++", 0, -7, 0, 0, 0, -21, -4, -32
"/home/sanjay/Desktop/Bitbucket/MarlinV2_morphle/Marlin/src/lcd/extui/dgus/mks/DGUSDisplayDef.cpp", "C++", 0, -567, 0, 0, 0, -111, -125, -803
"/home/sanjay/Desktop/Bitbucket/MarlinV2_morphle/Marlin/src/lcd/extui/dgus/mks/DGUSDisplayDef.h", "C++", 0, -519, 0, 0, 0, -87, -107, -713
"/home/sanjay/Desktop/Bitbucket/MarlinV2_morphle/Marlin/src/lcd/extui/dgus/mks/DGUSScreenHandler.cpp", "C++", 0, -1567, 0, 0, 0, -83, -379, -2029
"/home/sanjay/Desktop/Bitbucket/MarlinV2_morphle/Marlin/src/lcd/extui/dgus/mks/DGUSScreenHandler.h", "C++", 0, -78, 0, 0, 0, -22, -17, -117
"/home/sanjay/Desktop/Bitbucket/MarlinV2_morphle/Marlin/src/lcd/extui/dgus/origin/DGUSDisplayDef.cpp", "C++", 0, -211, 0, 0, 0, -37, -32, -280
"/home/sanjay/Desktop/Bitbucket/MarlinV2_morphle/Marlin/src/lcd/extui/dgus/origin/DGUSDisplayDef.h", "C++", 0, -126, 0, 0, 0, -114, -43, -283
"/home/sanjay/Desktop/Bitbucket/MarlinV2_morphle/Marlin/src/lcd/extui/dgus/origin/DGUSScreenHandler.cpp", "C++", 0, -320, 0, 0, 0, -44, -60, -424
"/home/sanjay/Desktop/Bitbucket/MarlinV2_morphle/Marlin/src/lcd/extui/dgus/origin/DGUSScreenHandler.h", "C++", 0, -7, 0, 0, 0, -21, -4, -32
"/home/sanjay/Desktop/Bitbucket/MarlinV2_morphle/Marlin/src/lcd/extui/dgus_reloaded/DGUSDisplay.cpp", "C++", 0, -297, 0, 0, 0, -34, -79, -410
"/home/sanjay/Desktop/Bitbucket/MarlinV2_morphle/Marlin/src/lcd/extui/dgus_reloaded/DGUSDisplay.h", "C++", 0, -98, 0, 0, 0, -40, -37, -175
"/home/sanjay/Desktop/Bitbucket/MarlinV2_morphle/Marlin/src/lcd/extui/dgus_reloaded/DGUSRxHandler.cpp", "C++", 0, -804, 0, 0, 0, -21, -219, -1044
"/home/sanjay/Desktop/Bitbucket/MarlinV2_morphle/Marlin/src/lcd/extui/dgus_reloaded/DGUSRxHandler.h", "C++", 0, -75, 0, 0, 0, -21, -27, -123
"/home/sanjay/Desktop/Bitbucket/MarlinV2_morphle/Marlin/src/lcd/extui/dgus_reloaded/DGUSScreenHandler.cpp", "C++", 0, -375, 0, 0, 0, -21, -122, -518
"/home/sanjay/Desktop/Bitbucket/MarlinV2_morphle/Marlin/src/lcd/extui/dgus_reloaded/DGUSScreenHandler.h", "C++", 0, -93, 0, 0, 0, -24, -35, -152
"/home/sanjay/Desktop/Bitbucket/MarlinV2_morphle/Marlin/src/lcd/extui/dgus_reloaded/DGUSSetupHandler.cpp", "C++", 0, -135, 0, 0, 0, -21, -54, -210
"/home/sanjay/Desktop/Bitbucket/MarlinV2_morphle/Marlin/src/lcd/extui/dgus_reloaded/DGUSSetupHandler.h", "C++", 0, -18, 0, 0, 0, -21, -4, -43
"/home/sanjay/Desktop/Bitbucket/MarlinV2_morphle/Marlin/src/lcd/extui/dgus_reloaded/DGUSTxHandler.cpp", "C++", 0, -491, 0, 0, 0, -23, -105, -619
"/home/sanjay/Desktop/Bitbucket/MarlinV2_morphle/Marlin/src/lcd/extui/dgus_reloaded/DGUSTxHandler.h", "C++", 0, -84, 0, 0, 0, -21, -22, -127
"/home/sanjay/Desktop/Bitbucket/MarlinV2_morphle/Marlin/src/lcd/extui/dgus_reloaded/config/DGUS_Addr.h", "C++", 0, -137, 0, 0, 0, -25, -12, -174
"/home/sanjay/Desktop/Bitbucket/MarlinV2_morphle/Marlin/src/lcd/extui/dgus_reloaded/config/DGUS_Constants.h", "C++", 0, -55, 0, 0, 0, -21, -21, -97
"/home/sanjay/Desktop/Bitbucket/MarlinV2_morphle/Marlin/src/lcd/extui/dgus_reloaded/config/DGUS_Control.h", "C++", 0, -17, 0, 0, 0, -26, -8, -51
"/home/sanjay/Desktop/Bitbucket/MarlinV2_morphle/Marlin/src/lcd/extui/dgus_reloaded/config/DGUS_Data.h", "C++", 0, -100, 0, 0, 0, -23, -26, -149
"/home/sanjay/Desktop/Bitbucket/MarlinV2_morphle/Marlin/src/lcd/extui/dgus_reloaded/config/DGUS_Screen.h", "C++", 0, -30, 0, 0, 0, -21, -2, -53
"/home/sanjay/Desktop/Bitbucket/MarlinV2_morphle/Marlin/src/lcd/extui/dgus_reloaded/definition/DGUS_ScreenAddrList.cpp", "C++", 0, -189, 0, 0, 0, -21, -31, -241
"/home/sanjay/Desktop/Bitbucket/MarlinV2_morphle/Marlin/src/lcd/extui/dgus_reloaded/definition/DGUS_ScreenAddrList.h", "C++", 0, -8, 0, 0, 0, -21, -4, -33
"/home/sanjay/Desktop/Bitbucket/MarlinV2_morphle/Marlin/src/lcd/extui/dgus_reloaded/definition/DGUS_ScreenSetup.cpp", "C++", 0, -27, 0, 0, 0, -21, -10, -58
"/home/sanjay/Desktop/Bitbucket/MarlinV2_morphle/Marlin/src/lcd/extui/dgus_reloaded/definition/DGUS_ScreenSetup.h", "C++", 0, -7, 0, 0, 0, -21, -4, -32
"/home/sanjay/Desktop/Bitbucket/MarlinV2_morphle/Marlin/src/lcd/extui/dgus_reloaded/definition/DGUS_VP.h", "C++", 0, -13, 0, 0, 0, -23, -5, -41
"/home/sanjay/Desktop/Bitbucket/MarlinV2_morphle/Marlin/src/lcd/extui/dgus_reloaded/definition/DGUS_VPList.cpp", "C++", 0, -283, 0, 0, 0, -25, -61, -369
"/home/sanjay/Desktop/Bitbucket/MarlinV2_morphle/Marlin/src/lcd/extui/dgus_reloaded/definition/DGUS_VPList.h", "C++", 0, -3, 0, 0, 0, -21, -3, -27
"/home/sanjay/Desktop/Bitbucket/MarlinV2_morphle/Marlin/src/lcd/extui/dgus_reloaded/dgus_reloaded_extui.cpp", "C++", 0, -85, 0, 0, 0, -27, -32, -144
"/home/sanjay/Desktop/Bitbucket/MarlinV2_morphle/Marlin/src/lcd/extui/example/example.cpp", "C++", 0, -59, 0, 0, 0, -56, -23, -138
"/home/sanjay/Desktop/Bitbucket/MarlinV2_morphle/Marlin/src/lcd/extui/ftdi_eve_touch_ui/archim2-flash/flash_storage.cpp", "C++", 0, -362, 0, 0, 0, -90, -101, -553
"/home/sanjay/Desktop/Bitbucket/MarlinV2_morphle/Marlin/src/lcd/extui/ftdi_eve_touch_ui/archim2-flash/flash_storage.h", "C++", 0, -67, 0, 0, 0, -20, -20, -107
"/home/sanjay/Desktop/Bitbucket/MarlinV2_morphle/Marlin/src/lcd/extui/ftdi_eve_touch_ui/archim2-flash/media_file_reader.cpp", "C++", 0, -32, 0, 0, 0, -20, -10, -62
"/home/sanjay/Desktop/Bitbucket/MarlinV2_morphle/Marlin/src/lcd/extui/ftdi_eve_touch_ui/archim2-flash/media_file_reader.h", "C++", 0, -19, 0, 0, 0, -20, -8, -47
"/home/sanjay/Desktop/Bitbucket/MarlinV2_morphle/Marlin/src/lcd/extui/ftdi_eve_touch_ui/bioprinter/advanced_settings.cpp", "C++", 0, -69, 0, 0, 0, -20, -14, -103
"/home/sanjay/Desktop/Bitbucket/MarlinV2_morphle/Marlin/src/lcd/extui/ftdi_eve_touch_ui/bioprinter/advanced_settings.h", "C++", 0, -8, 0, 0, 0, -20, -5, -33
"/home/sanjay/Desktop/Bitbucket/MarlinV2_morphle/Marlin/src/lcd/extui/ftdi_eve_touch_ui/bioprinter/confirm_home_e.cpp", "C++", 0, -29, 0, 0, 0, -20, -8, -57
"/home/sanjay/Desktop/Bitbucket/MarlinV2_morphle/Marlin/src/lcd/extui/ftdi_eve_touch_ui/bioprinter/confirm_home_e.h", "C++", 0, -8, 0, 0, 0, -20, -5, -33
"/home/sanjay/Desktop/Bitbucket/MarlinV2_morphle/Marlin/src/lcd/extui/ftdi_eve_touch_ui/bioprinter/confirm_home_xyz.cpp", "C++", 0, -28, 0, 0, 0, -20, -8, -56
"/home/sanjay/Desktop/Bitbucket/MarlinV2_morphle/Marlin/src/lcd/extui/ftdi_eve_touch_ui/bioprinter/confirm_home_xyz.h", "C++", 0, -8, 0, 0, 0, -20, -5, -33
"/home/sanjay/Desktop/Bitbucket/MarlinV2_morphle/Marlin/src/lcd/extui/ftdi_eve_touch_ui/bioprinter/main_menu.cpp", "C++", 0, -53, 0, 0, 0, -20, -13, -86
"/home/sanjay/Desktop/Bitbucket/MarlinV2_morphle/Marlin/src/lcd/extui/ftdi_eve_touch_ui/bioprinter/main_menu.h", "C++", 0, -8, 0, 0, 0, -20, -5, -33
"/home/sanjay/Desktop/Bitbucket/MarlinV2_morphle/Marlin/src/lcd/extui/ftdi_eve_touch_ui/bioprinter/printing_dialog_box.cpp", "C++", 0, -109, 0, 0, 0, -20, -23, -152
"/home/sanjay/Desktop/Bitbucket/MarlinV2_morphle/Marlin/src/lcd/extui/ftdi_eve_touch_ui/bioprinter/printing_dialog_box.h", "C++", 0, -17, 0, 0, 0, -20, -8, -45
"/home/sanjay/Desktop/Bitbucket/MarlinV2_morphle/Marlin/src/lcd/extui/ftdi_eve_touch_ui/bioprinter/screens.h", "C++", 0, -69, 0, 0, 0, -27, -10, -106
"/home/sanjay/Desktop/Bitbucket/MarlinV2_morphle/Marlin/src/lcd/extui/ftdi_eve_touch_ui/bioprinter/status_screen.cpp", "C++", 0, -285, 0, 0, 0, -31, -61, -377
"/home/sanjay/Desktop/Bitbucket/MarlinV2_morphle/Marlin/src/lcd/extui/ftdi_eve_touch_ui/bioprinter/status_screen.h", "C++", 0, -26, 0, 0, 0, -21, -10, -57
"/home/sanjay/Desktop/Bitbucket/MarlinV2_morphle/Marlin/src/lcd/extui/ftdi_eve_touch_ui/bioprinter/tune_menu.cpp", "C++", 0, -47, 0, 0, 0, -20, -10, -77
"/home/sanjay/Desktop/Bitbucket/MarlinV2_morphle/Marlin/src/lcd/extui/ftdi_eve_touch_ui/bioprinter/tune_menu.h", "C++", 0, -11, 0, 0, 0, -20, -5, -36
"/home/sanjay/Desktop/Bitbucket/MarlinV2_morphle/Marlin/src/lcd/extui/ftdi_eve_touch_ui/bioprinter/ui_landscape.h", "C++", 0, -33, 0, 0, 0, -24, -5, -62
"/home/sanjay/Desktop/Bitbucket/MarlinV2_morphle/Marlin/src/lcd/extui/ftdi_eve_touch_ui/bioprinter/ui_portrait.h", "C++", 0, -26, 0, 0, 0, -24, -5, -55
"/home/sanjay/Desktop/Bitbucket/MarlinV2_morphle/Marlin/src/lcd/extui/ftdi_eve_touch_ui/cocoa_press/advanced_settings_menu.cpp", "C++", 0, -67, 0, 0, 0, -20, -9, -96
"/home/sanjay/Desktop/Bitbucket/MarlinV2_morphle/Marlin/src/lcd/extui/ftdi_eve_touch_ui/cocoa_press/advanced_settings_menu.h", "C++", 0, -8, 0, 0, 0, -20, -5, -33
"/home/sanjay/Desktop/Bitbucket/MarlinV2_morphle/Marlin/src/lcd/extui/ftdi_eve_touch_ui/cocoa_press/cocoa_press_ui.h", "C++", 0, -35, 0, 0, 0, -21, -5, -61
"/home/sanjay/Desktop/Bitbucket/MarlinV2_morphle/Marlin/src/lcd/extui/ftdi_eve_touch_ui/cocoa_press/leveling_menu.cpp", "C++", 0, -61, 0, 0, 0, -20, -11, -92
"/home/sanjay/Desktop/Bitbucket/MarlinV2_morphle/Marlin/src/lcd/extui/ftdi_eve_touch_ui/cocoa_press/leveling_menu.h", "C++", 0, -8, 0, 0, 0, -20, -5, -33
"/home/sanjay/Desktop/Bitbucket/MarlinV2_morphle/Marlin/src/lcd/extui/ftdi_eve_touch_ui/cocoa_press/load_chocolate.cpp", "C++", 0, -154, 0, 0, 0, -26, -39, -219
"/home/sanjay/Desktop/Bitbucket/MarlinV2_morphle/Marlin/src/lcd/extui/ftdi_eve_touch_ui/cocoa_press/load_chocolate.h", "C++", 0, -21, 0, 0, 0, -21, -6, -48
"/home/sanjay/Desktop/Bitbucket/MarlinV2_morphle/Marlin/src/lcd/extui/ftdi_eve_touch_ui/cocoa_press/main_menu.cpp", "C++", 0, -68, 0, 0, 0, -21, -12, -101
"/home/sanjay/Desktop/Bitbucket/MarlinV2_morphle/Marlin/src/lcd/extui/ftdi_eve_touch_ui/cocoa_press/main_menu.h", "C++", 0, -8, 0, 0, 0, -21, -5, -34
"/home/sanjay/Desktop/Bitbucket/MarlinV2_morphle/Marlin/src/lcd/extui/ftdi_eve_touch_ui/cocoa_press/move_e_screen.cpp", "C++", 0, -35, 0, 0, 0, -21, -8, -64
"/home/sanjay/Desktop/Bitbucket/MarlinV2_morphle/Marlin/src/lcd/extui/ftdi_eve_touch_ui/cocoa_press/move_e_screen.h", "C++", 0, -8, 0, 0, 0, -21, -5, -34
"/home/sanjay/Desktop/Bitbucket/MarlinV2_morphle/Marlin/src/lcd/extui/ftdi_eve_touch_ui/cocoa_press/move_xyz_screen.cpp", "C++", 0, -25, 0, 0, 0, -21, -7, -53
"/home/sanjay/Desktop/Bitbucket/MarlinV2_morphle/Marlin/src/lcd/extui/ftdi_eve_touch_ui/cocoa_press/move_xyz_screen.h", "C++", 0, -8, 0, 0, 0, -21, -5, -34
"/home/sanjay/Desktop/Bitbucket/MarlinV2_morphle/Marlin/src/lcd/extui/ftdi_eve_touch_ui/cocoa_press/preheat_menu.cpp", "C++", 0, -87, 0, 0, 0, -19, -11, -117
"/home/sanjay/Desktop/Bitbucket/MarlinV2_morphle/Marlin/src/lcd/extui/ftdi_eve_touch_ui/cocoa_press/preheat_menu.h", "C++", 0, -8, 0, 0, 0, -19, -5, -32
"/home/sanjay/Desktop/Bitbucket/MarlinV2_morphle/Marlin/src/lcd/extui/ftdi_eve_touch_ui/cocoa_press/preheat_screen.cpp", "C++", 0, -116, 0, 0, 0, -21, -25, -162
"/home/sanjay/Desktop/Bitbucket/MarlinV2_morphle/Marlin/src/lcd/extui/ftdi_eve_touch_ui/cocoa_press/preheat_screen.h", "C++", 0, -20, 0, 0, 0, -19, -8, -47
"/home/sanjay/Desktop/Bitbucket/MarlinV2_morphle/Marlin/src/lcd/extui/ftdi_eve_touch_ui/cocoa_press/screens.h", "C++", 0, -96, 0, 0, 0, -27, -12, -135
"/home/sanjay/Desktop/Bitbucket/MarlinV2_morphle/Marlin/src/lcd/extui/ftdi_eve_touch_ui/cocoa_press/status_screen.cpp", "C++", 0, -219, 0, 0, 0, -26, -63, -308
"/home/sanjay/Desktop/Bitbucket/MarlinV2_morphle/Marlin/src/lcd/extui/ftdi_eve_touch_ui/cocoa_press/status_screen.h", "C++", 0, -28, 0, 0, 0, -21, -9, -58
"/home/sanjay/Desktop/Bitbucket/MarlinV2_morphle/Marlin/src/lcd/extui/ftdi_eve_touch_ui/compat.h", "C++", 0, -23, 0, 0, 0, -24, -7, -54
"/home/sanjay/Desktop/Bitbucket/MarlinV2_morphle/Marlin/src/lcd/extui/ftdi_eve_touch_ui/config.h", "C++", 0, -5, 0, 0, 0, -20, -6, -31
"/home/sanjay/Desktop/Bitbucket/MarlinV2_morphle/Marlin/src/lcd/extui/ftdi_eve_touch_ui/ftdi_eve_extui.cpp", "C++", 0, -108, 0, 0, 0, -26, -27, -161
"/home/sanjay/Desktop/Bitbucket/MarlinV2_morphle/Marlin/src/lcd/extui/ftdi_eve_touch_ui/ftdi_eve_lib/README.md", "Markdown", 0, 0, 0, -22, 0, 0, -7, -29
"/home/sanjay/Desktop/Bitbucket/MarlinV2_morphle/Marlin/src/lcd/extui/ftdi_eve_touch_ui/ftdi_eve_lib/basic/boards.h", "C++", 0, -197, 0, 0, 0, -63, -22, -282
"/home/sanjay/Desktop/Bitbucket/MarlinV2_morphle/Marlin/src/lcd/extui/ftdi_eve_touch_ui/ftdi_eve_lib/basic/commands.cpp", "C++", 0, -938, 0, 0, 0, -76, -205, -1219
"/home/sanjay/Desktop/Bitbucket/MarlinV2_morphle/Marlin/src/lcd/extui/ftdi_eve_touch_ui/ftdi_eve_lib/basic/commands.h", "C++", 0, -133, 0, 0, 0, -94, -37, -264
"/home/sanjay/Desktop/Bitbucket/MarlinV2_morphle/Marlin/src/lcd/extui/ftdi_eve_touch_ui/ftdi_eve_lib/basic/constants.h", "C++", 0, -353, 0, 0, 0, -29, -34, -416
"/home/sanjay/Desktop/Bitbucket/MarlinV2_morphle/Marlin/src/lcd/extui/ftdi_eve_touch_ui/ftdi_eve_lib/basic/display_list.h", "C++", 0, -79, 0, 0, 0, -33, -7, -119
"/home/sanjay/Desktop/Bitbucket/MarlinV2_morphle/Marlin/src/lcd/extui/ftdi_eve_touch_ui/ftdi_eve_lib/basic/ftdi_basic.h", "C++", 0, -15, 0, 0, 0, -20, -6, -41
"/home/sanjay/Desktop/Bitbucket/MarlinV2_morphle/Marlin/src/lcd/extui/ftdi_eve_touch_ui/ftdi_eve_lib/basic/registers_ft800.h", "C++", 0, -90, 0, 0, 0, -50, -11, -151
"/home/sanjay/Desktop/Bitbucket/MarlinV2_morphle/Marlin/src/lcd/extui/ftdi_eve_touch_ui/ftdi_eve_lib/basic/registers_ft810.h", "C++", 0, -115, 0, 0, 0, -61, -12, -188
"/home/sanjay/Desktop/Bitbucket/MarlinV2_morphle/Marlin/src/lcd/extui/ftdi_eve_touch_ui/ftdi_eve_lib/basic/resolutions.h", "C++", 0, -94, 0, 0, 0, -31, -18, -143
"/home/sanjay/Desktop/Bitbucket/MarlinV2_morphle/Marlin/src/lcd/extui/ftdi_eve_touch_ui/ftdi_eve_lib/basic/spi.cpp", "C++", 0, -123, 0, 0, 0, -27, -26, -176
"/home/sanjay/Desktop/Bitbucket/MarlinV2_morphle/Marlin/src/lcd/extui/ftdi_eve_touch_ui/ftdi_eve_lib/basic/spi.h", "C++", 0, -90, 0, 0, 0, -22, -25, -137
"/home/sanjay/Desktop/Bitbucket/MarlinV2_morphle/Marlin/src/lcd/extui/ftdi_eve_touch_ui/ftdi_eve_lib/compat.h", "C++", 0, -271, 0, 0, 0, -24, -36, -331
"/home/sanjay/Desktop/Bitbucket/MarlinV2_morphle/Marlin/src/lcd/extui/ftdi_eve_touch_ui/ftdi_eve_lib/extended/adjuster_widget.cpp", "C++", 0, -31, 0, 0, 0, -19, -11, -61
"/home/sanjay/Desktop/Bitbucket/MarlinV2_morphle/Marlin/src/lcd/extui/ftdi_eve_touch_ui/ftdi_eve_lib/extended/adjuster_widget.h", "C++", 0, -17, 0, 0, 0, -19, -5, -41
"/home/sanjay/Desktop/Bitbucket/MarlinV2_morphle/Marlin/src/lcd/extui/ftdi_eve_touch_ui/ftdi_eve_lib/extended/arrows.cpp", "C++", 0, -24, 0, 0, 0, -19, -10, -53
"/home/sanjay/Desktop/Bitbucket/MarlinV2_morphle/Marlin/src/lcd/extui/ftdi_eve_touch_ui/ftdi_eve_lib/extended/arrows.h", "C++", 0, -5, 0, 0, 0, -19, -5, -29
"/home/sanjay/Desktop/Bitbucket/MarlinV2_morphle/Marlin/src/lcd/extui/ftdi_eve_touch_ui/ftdi_eve_lib/extended/bitmap_info.h", "C++", 0, -19, 0, 0, 0, -24, -7, -50
"/home/sanjay/Desktop/Bitbucket/MarlinV2_morphle/Marlin/src/lcd/extui/ftdi_eve_touch_ui/ftdi_eve_lib/extended/circular_progress.cpp", "C++", 0, -64, 0, 0, 0, -28, -17, -109
"/home/sanjay/Desktop/Bitbucket/MarlinV2_morphle/Marlin/src/lcd/extui/ftdi_eve_touch_ui/ftdi_eve_lib/extended/circular_progress.h", "C++", 0, -5, 0, 0, 0, -19, -4, -28
"/home/sanjay/Desktop/Bitbucket/MarlinV2_morphle/Marlin/src/lcd/extui/ftdi_eve_touch_ui/ftdi_eve_lib/extended/command_processor.cpp", "C++", 0, -15, 0, 0, 0, -19, -8, -42
"/home/sanjay/Desktop/Bitbucket/MarlinV2_morphle/Marlin/src/lcd/extui/ftdi_eve_touch_ui/ftdi_eve_lib/extended/command_processor.h", "C++", 0, -358, 0, 0, 0, -41, -54, -453
"/home/sanjay/Desktop/Bitbucket/MarlinV2_morphle/Marlin/src/lcd/extui/ftdi_eve_touch_ui/ftdi_eve_lib/extended/dl_cache.cpp", "C++", 0, -85, 0, 0, 0, -68, -22, -175
"/home/sanjay/Desktop/Bitbucket/MarlinV2_morphle/Marlin/src/lcd/extui/ftdi_eve_touch_ui/ftdi_eve_lib/extended/dl_cache.h", "C++", 0, -25, 0, 0, 0, -34, -12, -71
"/home/sanjay/Desktop/Bitbucket/MarlinV2_morphle/Marlin/src/lcd/extui/ftdi_eve_touch_ui/ftdi_eve_lib/extended/event_loop.cpp", "C++", 0, -141, 0, 0, 0, -50, -36, -227
"/home/sanjay/Desktop/Bitbucket/MarlinV2_morphle/Marlin/src/lcd/extui/ftdi_eve_touch_ui/ftdi_eve_lib/extended/event_loop.h", "C++", 0, -44, 0, 0, 0, -20, -11, -75
"/home/sanjay/Desktop/Bitbucket/MarlinV2_morphle/Marlin/src/lcd/extui/ftdi_eve_touch_ui/ftdi_eve_lib/extended/ftdi_extended.h", "C++", 0, -31, 0, 0, 0, -20, -6, -57
"/home/sanjay/Desktop/Bitbucket/MarlinV2_morphle/Marlin/src/lcd/extui/ftdi_eve_touch_ui/ftdi_eve_lib/extended/grid_layout.h", "C++", 0, -66, 0, 0, 0, -40, -18, -124
"/home/sanjay/Desktop/Bitbucket/MarlinV2_morphle/Marlin/src/lcd/extui/ftdi_eve_touch_ui/ftdi_eve_lib/extended/poly_ui.h", "C++", 0, -262, 0, 0, 0, -98, -49, -409
"/home/sanjay/Desktop/Bitbucket/MarlinV2_morphle/Marlin/src/lcd/extui/ftdi_eve_touch_ui/ftdi_eve_lib/extended/polygon.h", "C++", 0, -39, 0, 0, 0, -46, -12, -97
"/home/sanjay/Desktop/Bitbucket/MarlinV2_morphle/Marlin/src/lcd/extui/ftdi_eve_touch_ui/ftdi_eve_lib/extended/rgb_t.h", "C++", 0, -44, 0, 0, 0, -27, -14, -85
"/home/sanjay/Desktop/Bitbucket/MarlinV2_morphle/Marlin/src/lcd/extui/ftdi_eve_touch_ui/ftdi_eve_lib/extended/screen_types.cpp", "C++", 0, -66, 0, 0, 0, -21, -18, -105
"/home/sanjay/Desktop/Bitbucket/MarlinV2_morphle/Marlin/src/lcd/extui/ftdi_eve_touch_ui/ftdi_eve_lib/extended/screen_types.h", "C++", 0, -171, 0, 0, 0, -33, -40, -244
"/home/sanjay/Desktop/Bitbucket/MarlinV2_morphle/Marlin/src/lcd/extui/ftdi_eve_touch_ui/ftdi_eve_lib/extended/sound_list.h", "C++", 0, -16, 0, 0, 0, -19, -4, -39
"/home/sanjay/Desktop/Bitbucket/MarlinV2_morphle/Marlin/src/lcd/extui/ftdi_eve_touch_ui/ftdi_eve_lib/extended/sound_player.cpp", "C++", 0, -61, 0, 0, 0, -24, -24, -109
"/home/sanjay/Desktop/Bitbucket/MarlinV2_morphle/Marlin/src/lcd/extui/ftdi_eve_touch_ui/ftdi_eve_lib/extended/sound_player.h", "C++", 0, -36, 0, 0, 0, -20, -15, -71
"/home/sanjay/Desktop/Bitbucket/MarlinV2_morphle/Marlin/src/lcd/extui/ftdi_eve_touch_ui/ftdi_eve_lib/extended/text_box.cpp", "C++", 0, -99, 0, 0, 0, -35, -16, -150
"/home/sanjay/Desktop/Bitbucket/MarlinV2_morphle/Marlin/src/lcd/extui/ftdi_eve_touch_ui/ftdi_eve_lib/extended/text_box.h", "C++", 0, -6, 0, 0, 0, -22, -5, -33
"/home/sanjay/Desktop/Bitbucket/MarlinV2_morphle/Marlin/src/lcd/extui/ftdi_eve_touch_ui/ftdi_eve_lib/extended/text_ellipsis.cpp", "C++", 0, -47, 0, 0, 0, -29, -12, -88
"/home/sanjay/Desktop/Bitbucket/MarlinV2_morphle/Marlin/src/lcd/extui/ftdi_eve_touch_ui/ftdi_eve_lib/extended/text_ellipsis.h", "C++", 0, -5, 0, 0, 0, -23, -4, -32
"/home/sanjay/Desktop/Bitbucket/MarlinV2_morphle/Marlin/src/lcd/extui/ftdi_eve_touch_ui/ftdi_eve_lib/extended/tiny_timer.cpp", "C++", 0, -15, 0, 0, 0, -19, -6, -40
"/home/sanjay/Desktop/Bitbucket/MarlinV2_morphle/Marlin/src/lcd/extui/ftdi_eve_touch_ui/ftdi_eve_lib/extended/tiny_timer.h", "C++", 0, -19, 0, 0, 0, -29, -9, -57
"/home/sanjay/Desktop/Bitbucket/MarlinV2_morphle/Marlin/src/lcd/extui/ftdi_eve_touch_ui/ftdi_eve_lib/extended/unicode/cyrillic_char_set.cpp", "C++", 0, -49, 0, 0, 0, -65, -26, -140
"/home/sanjay/Desktop/Bitbucket/MarlinV2_morphle/Marlin/src/lcd/extui/ftdi_eve_touch_ui/ftdi_eve_lib/extended/unicode/cyrillic_char_set.h", "C++", 0, -10, 0, 0, 0, -20, -3, -33
"/home/sanjay/Desktop/Bitbucket/MarlinV2_morphle/Marlin/src/lcd/extui/ftdi_eve_touch_ui/ftdi_eve_lib/extended/unicode/cyrillic_char_set_bitmap_31.h", "C++", 0, -2356, 0, 0, 0, -94, -80, -2530
"/home/sanjay/Desktop/Bitbucket/MarlinV2_morphle/Marlin/src/lcd/extui/ftdi_eve_touch_ui/ftdi_eve_lib/extended/unicode/font_bitmaps.cpp", "C++", 0, -30, 0, 0, 0, -19, -10, -59
"/home/sanjay/Desktop/Bitbucket/MarlinV2_morphle/Marlin/src/lcd/extui/ftdi_eve_touch_ui/ftdi_eve_lib/extended/unicode/font_bitmaps.h", "C++", 0, -7, 0, 0, 0, -19, -5, -31
"/home/sanjay/Desktop/Bitbucket/MarlinV2_morphle/Marlin/src/lcd/extui/ftdi_eve_touch_ui/ftdi_eve_lib/extended/unicode/font_bitmaps/cyrillic_char_set_bitmap_31.svg", "XML", 0, 0, 0, 0, -535, 0, -1, -536
"/home/sanjay/Desktop/Bitbucket/MarlinV2_morphle/Marlin/src/lcd/extui/ftdi_eve_touch_ui/ftdi_eve_lib/extended/unicode/font_bitmaps/western_char_set_bitmap_31.svg", "XML", 0, 0, 0, 0, -441, -1, -2, -444
"/home/sanjay/Desktop/Bitbucket/MarlinV2_morphle/Marlin/src/lcd/extui/ftdi_eve_touch_ui/ftdi_eve_lib/extended/unicode/font_size_t.cpp", "C++", 0, -17, 0, 0, 0, -22, -8, -47
"/home/sanjay/Desktop/Bitbucket/MarlinV2_morphle/Marlin/src/lcd/extui/ftdi_eve_touch_ui/ftdi_eve_lib/extended/unicode/font_size_t.h", "C++", 0, -17, 0, 0, 0, -27, -12, -56
"/home/sanjay/Desktop/Bitbucket/MarlinV2_morphle/Marlin/src/lcd/extui/ftdi_eve_touch_ui/ftdi_eve_lib/extended/unicode/standard_char_set.cpp", "C++", 0, -33, 0, 0, 0, -58, -17, -108
"/home/sanjay/Desktop/Bitbucket/MarlinV2_morphle/Marlin/src/lcd/extui/ftdi_eve_touch_ui/ftdi_eve_lib/extended/unicode/standard_char_set.h", "C++", 0, -9, 0, 0, 0, -19, -3, -31
"/home/sanjay/Desktop/Bitbucket/MarlinV2_morphle/Marlin/src/lcd/extui/ftdi_eve_touch_ui/ftdi_eve_lib/extended/unicode/unicode.cpp", "C++", 0, -111, 0, 0, 0, -109, -28, -248
"/home/sanjay/Desktop/Bitbucket/MarlinV2_morphle/Marlin/src/lcd/extui/ftdi_eve_touch_ui/ftdi_eve_lib/extended/unicode/unicode.h", "C++", 0, -61, 0, 0, 0, -28, -24, -113
"/home/sanjay/Desktop/Bitbucket/MarlinV2_morphle/Marlin/src/lcd/extui/ftdi_eve_touch_ui/ftdi_eve_lib/extended/unicode/western_char_set.cpp", "C++", 0, -334, 0, 0, 0, -77, -45, -456
"/home/sanjay/Desktop/Bitbucket/MarlinV2_morphle/Marlin/src/lcd/extui/ftdi_eve_touch_ui/ftdi_eve_lib/extended/unicode/western_char_set.h", "C++", 0, -10, 0, 0, 0, -19, -3, -32
"/home/sanjay/Desktop/Bitbucket/MarlinV2_morphle/Marlin/src/lcd/extui/ftdi_eve_touch_ui/ftdi_eve_lib/extended/unicode/western_char_set_bitmap_31.h", "C++", 0, -1201, 0, 0, 0, -67, -48, -1316
"/home/sanjay/Desktop/Bitbucket/MarlinV2_morphle/Marlin/src/lcd/extui/ftdi_eve_touch_ui/ftdi_eve_lib/ftdi_eve_lib.h", "C++", 0, -4, 0, 0, 0, -20, -4, -28
"/home/sanjay/Desktop/Bitbucket/MarlinV2_morphle/Marlin/src/lcd/extui/ftdi_eve_touch_ui/ftdi_eve_lib/scripts/file2cpp.py", "Python", 0, 0, -25, 0, 0, -15, -8, -48
"/home/sanjay/Desktop/Bitbucket/MarlinV2_morphle/Marlin/src/lcd/extui/ftdi_eve_touch_ui/ftdi_eve_lib/scripts/font2cpp.py", "Python", 0, 0, -71, 0, 0, -23, -15, -109
"/home/sanjay/Desktop/Bitbucket/MarlinV2_morphle/Marlin/src/lcd/extui/ftdi_eve_touch_ui/ftdi_eve_lib/scripts/img2cpp.py", "Python", 0, 0, -81, 0, 0, -15, -18, -114
"/home/sanjay/Desktop/Bitbucket/MarlinV2_morphle/Marlin/src/lcd/extui/ftdi_eve_touch_ui/ftdi_eve_lib/scripts/svg2cpp.py", "Python", 0, 0, -209, 0, 0, -31, -41, -281
"/home/sanjay/Desktop/Bitbucket/MarlinV2_morphle/Marlin/src/lcd/extui/ftdi_eve_touch_ui/generic/about_screen.cpp", "C++", 0, -81, 0, 0, 0, -22, -14, -117
"/home/sanjay/Desktop/Bitbucket/MarlinV2_morphle/Marlin/src/lcd/extui/ftdi_eve_touch_ui/generic/about_screen.h", "C++", 0, -9, 0, 0, 0, -20, -5, -34
"/home/sanjay/Desktop/Bitbucket/MarlinV2_morphle/Marlin/src/lcd/extui/ftdi_eve_touch_ui/generic/advanced_settings_menu.cpp", "C++", 0, -126, 0, 0, 0, -20, -10, -156
"/home/sanjay/Desktop/Bitbucket/MarlinV2_morphle/Marlin/src/lcd/extui/ftdi_eve_touch_ui/generic/advanced_settings_menu.h", "C++", 0, -8, 0, 0, 0, -20, -5, -33
"/home/sanjay/Desktop/Bitbucket/MarlinV2_morphle/Marlin/src/lcd/extui/ftdi_eve_touch_ui/generic/alert_dialog_box.cpp", "C++", 0, -39, 0, 0, 0, -20, -13, -72
"/home/sanjay/Desktop/Bitbucket/MarlinV2_morphle/Marlin/src/lcd/extui/ftdi_eve_touch_ui/generic/alert_dialog_box.h", "C++", 0, -14, 0, 0, 0, -20, -6, -40
"/home/sanjay/Desktop/Bitbucket/MarlinV2_morphle/Marlin/src/lcd/extui/ftdi_eve_touch_ui/generic/backlash_compensation_screen.cpp", "C++", 0, -48, 0, 0, 0, -20, -8, -76
"/home/sanjay/Desktop/Bitbucket/MarlinV2_morphle/Marlin/src/lcd/extui/ftdi_eve_touch_ui/generic/backlash_compensation_screen.h", "C++", 0, -8, 0, 0, 0, -20, -5, -33
"/home/sanjay/Desktop/Bitbucket/MarlinV2_morphle/Marlin/src/lcd/extui/ftdi_eve_touch_ui/generic/base_numeric_adjustment_screen.cpp", "C++", 0, -314, 0, 0, 0, -27, -51, -392
"/home/sanjay/Desktop/Bitbucket/MarlinV2_morphle/Marlin/src/lcd/extui/ftdi_eve_touch_ui/generic/base_numeric_adjustment_screen.h", "C++", 0, -56, 0, 0, 0, -20, -12, -88
"/home/sanjay/Desktop/Bitbucket/MarlinV2_morphle/Marlin/src/lcd/extui/ftdi_eve_touch_ui/generic/base_screen.cpp", "C++", 0, -53, 0, 0, 0, -20, -15, -88
"/home/sanjay/Desktop/Bitbucket/MarlinV2_morphle/Marlin/src/lcd/extui/ftdi_eve_touch_ui/generic/base_screen.h", "C++", 0, -15, 0, 0, 0, -20, -9, -44
"/home/sanjay/Desktop/Bitbucket/MarlinV2_morphle/Marlin/src/lcd/extui/ftdi_eve_touch_ui/generic/bed_mesh_base.cpp", "C++", 0, -158, 0, 0, 0, -35, -32, -225
"/home/sanjay/Desktop/Bitbucket/MarlinV2_morphle/Marlin/src/lcd/extui/ftdi_eve_touch_ui/generic/bed_mesh_base.h", "C++", 0, -20, 0, 0, 0, -19, -8, -47
"/home/sanjay/Desktop/Bitbucket/MarlinV2_morphle/Marlin/src/lcd/extui/ftdi_eve_touch_ui/generic/bed_mesh_edit_screen.cpp", "C++", 0, -150, 0, 0, 0, -22, -29, -201
"/home/sanjay/Desktop/Bitbucket/MarlinV2_morphle/Marlin/src/lcd/extui/ftdi_eve_touch_ui/generic/bed_mesh_edit_screen.h", "C++", 0, -26, 0, 0, 0, -19, -6, -51
"/home/sanjay/Desktop/Bitbucket/MarlinV2_morphle/Marlin/src/lcd/extui/ftdi_eve_touch_ui/generic/bed_mesh_view_screen.cpp", "C++", 0, -122, 0, 0, 0, -19, -25, -166
"/home/sanjay/Desktop/Bitbucket/MarlinV2_morphle/Marlin/src/lcd/extui/ftdi_eve_touch_ui/generic/bed_mesh_view_screen.h", "C++", 0, -22, 0, 0, 0, -19, -7, -48
"/home/sanjay/Desktop/Bitbucket/MarlinV2_morphle/Marlin/src/lcd/extui/ftdi_eve_touch_ui/generic/boot_screen.cpp", "C++", 0, -80, 0, 0, 0, -29, -22, -131
"/home/sanjay/Desktop/Bitbucket/MarlinV2_morphle/Marlin/src/lcd/extui/ftdi_eve_touch_ui/generic/boot_screen.h", "C++", 0, -10, 0, 0, 0, -21, -5, -36
"/home/sanjay/Desktop/Bitbucket/MarlinV2_morphle/Marlin/src/lcd/extui/ftdi_eve_touch_ui/generic/case_light_screen.cpp", "C++", 0, -34, 0, 0, 0, -19, -9, -62
"/home/sanjay/Desktop/Bitbucket/MarlinV2_morphle/Marlin/src/lcd/extui/ftdi_eve_touch_ui/generic/case_light_screen.h", "C++", 0, -8, 0, 0, 0, -19, -5, -32
"/home/sanjay/Desktop/Bitbucket/MarlinV2_morphle/Marlin/src/lcd/extui/ftdi_eve_touch_ui/generic/change_filament_screen.cpp", "C++", 0, -270, 0, 0, 0, -24, -38, -332
"/home/sanjay/Desktop/Bitbucket/MarlinV2_morphle/Marlin/src/lcd/extui/ftdi_eve_touch_ui/generic/change_filament_screen.h", "C++", 0, -26, 0, 0, 0, -20, -6, -52
"/home/sanjay/Desktop/Bitbucket/MarlinV2_morphle/Marlin/src/lcd/extui/ftdi_eve_touch_ui/generic/confirm_abort_print_dialog_box.cpp", "C++", 0, -24, 0, 0, 0, -20, -9, -53
"/home/sanjay/Desktop/Bitbucket/MarlinV2_morphle/Marlin/src/lcd/extui/ftdi_eve_touch_ui/generic/confirm_abort_print_dialog_box.h", "C++", 0, -8, 0, 0, 0, -20, -5, -33
"/home/sanjay/Desktop/Bitbucket/MarlinV2_morphle/Marlin/src/lcd/extui/ftdi_eve_touch_ui/generic/confirm_auto_calibration_dialog_box.cpp", "C++", 0, -20, 0, 0, 0, -20, -8, -48
"/home/sanjay/Desktop/Bitbucket/MarlinV2_morphle/Marlin/src/lcd/extui/ftdi_eve_touch_ui/generic/confirm_auto_calibration_dialog_box.h", "C++", 0, -8, 0, 0, 0, -20, -5, -33
"/home/sanjay/Desktop/Bitbucket/MarlinV2_morphle/Marlin/src/lcd/extui/ftdi_eve_touch_ui/generic/confirm_erase_flash_dialog_box.cpp", "C++", 0, -23, 0, 0, 0, -22, -9, -54
"/home/sanjay/Desktop/Bitbucket/MarlinV2_morphle/Marlin/src/lcd/extui/ftdi_eve_touch_ui/generic/confirm_erase_flash_dialog_box.h", "C++", 0, -8, 0, 0, 0, -20, -5, -33
"/home/sanjay/Desktop/Bitbucket/MarlinV2_morphle/Marlin/src/lcd/extui/ftdi_eve_touch_ui/generic/confirm_start_print_dialog_box.cpp", "C++", 0, -36, 0, 0, 0, -20, -11, -67
"/home/sanjay/Desktop/Bitbucket/MarlinV2_morphle/Marlin/src/lcd/extui/ftdi_eve_touch_ui/generic/confirm_start_print_dialog_box.h", "C++", 0, -15, 0, 0, 0, -20, -8, -43
"/home/sanjay/Desktop/Bitbucket/MarlinV2_morphle/Marlin/src/lcd/extui/ftdi_eve_touch_ui/generic/confirm_user_request_alert_box.cpp", "C++", 0, -39, 0, 0, 0, -21, -10, -70
"/home/sanjay/Desktop/Bitbucket/MarlinV2_morphle/Marlin/src/lcd/extui/ftdi_eve_touch_ui/generic/confirm_user_request_alert_box.h", "C++", 0, -10, 0, 0, 0, -20, -5, -35
"/home/sanjay/Desktop/Bitbucket/MarlinV2_morphle/Marlin/src/lcd/extui/ftdi_eve_touch_ui/generic/custom_user_menus.cpp", "C++", 0, -179, 0, 0, 0, -21, -12, -212
"/home/sanjay/Desktop/Bitbucket/MarlinV2_morphle/Marlin/src/lcd/extui/ftdi_eve_touch_ui/generic/custom_user_menus.h", "C++", 0, -8, 0, 0, 0, -21, -3, -32
"/home/sanjay/Desktop/Bitbucket/MarlinV2_morphle/Marlin/src/lcd/extui/ftdi_eve_touch_ui/generic/default_acceleration_screen.cpp", "C++", 0, -35, 0, 0, 0, -20, -8, -63
"/home/sanjay/Desktop/Bitbucket/MarlinV2_morphle/Marlin/src/lcd/extui/ftdi_eve_touch_ui/generic/default_acceleration_screen.h", "C++", 0, -8, 0, 0, 0, -20, -5, -33
"/home/sanjay/Desktop/Bitbucket/MarlinV2_morphle/Marlin/src/lcd/extui/ftdi_eve_touch_ui/generic/developer_menu.cpp", "C++", 0, -113, 0, 0, 0, -20, -17, -150
"/home/sanjay/Desktop/Bitbucket/MarlinV2_morphle/Marlin/src/lcd/extui/ftdi_eve_touch_ui/generic/developer_menu.h", "C++", 0, -8, 0, 0, 0, -20, -5, -33
"/home/sanjay/Desktop/Bitbucket/MarlinV2_morphle/Marlin/src/lcd/extui/ftdi_eve_touch_ui/generic/dialog_box_base_class.cpp", "C++", 0, -49, 0, 0, 0, -20, -15, -84
"/home/sanjay/Desktop/Bitbucket/MarlinV2_morphle/Marlin/src/lcd/extui/ftdi_eve_touch_ui/generic/dialog_box_base_class.h", "C++", 0, -15, 0, 0, 0, -20, -8, -43
"/home/sanjay/Desktop/Bitbucket/MarlinV2_morphle/Marlin/src/lcd/extui/ftdi_eve_touch_ui/generic/display_tuning_screen.cpp", "C++", 0, -33, 0, 0, 0, -20, -8, -61
"/home/sanjay/Desktop/Bitbucket/MarlinV2_morphle/Marlin/src/lcd/extui/ftdi_eve_touch_ui/generic/display_tuning_screen.h", "C++", 0, -8, 0, 0, 0, -20, -5, -33
"/home/sanjay/Desktop/Bitbucket/MarlinV2_morphle/Marlin/src/lcd/extui/ftdi_eve_touch_ui/generic/endstop_state_screen.cpp", "C++", 0, -107, 0, 0, 0, -20, -17, -144
"/home/sanjay/Desktop/Bitbucket/MarlinV2_morphle/Marlin/src/lcd/extui/ftdi_eve_touch_ui/generic/endstop_state_screen.h", "C++", 0, -11, 0, 0, 0, -20, -5, -36
"/home/sanjay/Desktop/Bitbucket/MarlinV2_morphle/Marlin/src/lcd/extui/ftdi_eve_touch_ui/generic/feedrate_percent_screen.cpp", "C++", 0, -23, 0, 0, 0, -20, -9, -52
"/home/sanjay/Desktop/Bitbucket/MarlinV2_morphle/Marlin/src/lcd/extui/ftdi_eve_touch_ui/generic/feedrate_percent_screen.h", "C++", 0, -8, 0, 0, 0, -20, -5, -33
"/home/sanjay/Desktop/Bitbucket/MarlinV2_morphle/Marlin/src/lcd/extui/ftdi_eve_touch_ui/generic/filament_menu.cpp", "C++", 0, -55, 0, 0, 0, -20, -10, -85
"/home/sanjay/Desktop/Bitbucket/MarlinV2_morphle/Marlin/src/lcd/extui/ftdi_eve_touch_ui/generic/filament_menu.h", "C++", 0, -8, 0, 0, 0, -20, -5, -33
"/home/sanjay/Desktop/Bitbucket/MarlinV2_morphle/Marlin/src/lcd/extui/ftdi_eve_touch_ui/generic/filament_runout_screen.cpp", "C++", 0, -35, 0, 0, 0, -20, -10, -65
"/home/sanjay/Desktop/Bitbucket/MarlinV2_morphle/Marlin/src/lcd/extui/ftdi_eve_touch_ui/generic/filament_runout_screen.h", "C++", 0, -8, 0, 0, 0, -20, -5, -33
"/home/sanjay/Desktop/Bitbucket/MarlinV2_morphle/Marlin/src/lcd/extui/ftdi_eve_touch_ui/generic/files_screen.cpp", "C++", 0, -233, 0, 0, 0, -20, -35, -288
"/home/sanjay/Desktop/Bitbucket/MarlinV2_morphle/Marlin/src/lcd/extui/ftdi_eve_touch_ui/generic/files_screen.h", "C++", 0, -40, 0, 0, 0, -20, -9, -69
"/home/sanjay/Desktop/Bitbucket/MarlinV2_morphle/Marlin/src/lcd/extui/ftdi_eve_touch_ui/generic/flow_percent_screen.cpp", "C++", 0, -23, 0, 0, 0, -19, -9, -51
"/home/sanjay/Desktop/Bitbucket/MarlinV2_morphle/Marlin/src/lcd/extui/ftdi_eve_touch_ui/generic/flow_percent_screen.h", "C++", 0, -8, 0, 0, 0, -19, -5, -32
"/home/sanjay/Desktop/Bitbucket/MarlinV2_morphle/Marlin/src/lcd/extui/ftdi_eve_touch_ui/generic/interface_settings_screen.cpp", "C++", 0, -222, 0, 0, 0, -21, -44, -287
"/home/sanjay/Desktop/Bitbucket/MarlinV2_morphle/Marlin/src/lcd/extui/ftdi_eve_touch_ui/generic/interface_settings_screen.h", "C++", 0, -39, 0, 0, 0, -20, -9, -68
"/home/sanjay/Desktop/Bitbucket/MarlinV2_morphle/Marlin/src/lcd/extui/ftdi_eve_touch_ui/generic/interface_sounds_screen.cpp", "C++", 0, -86, 0, 0, 0, -20, -20, -126
"/home/sanjay/Desktop/Bitbucket/MarlinV2_morphle/Marlin/src/lcd/extui/ftdi_eve_touch_ui/generic/interface_sounds_screen.h", "C++", 0, -24, 0, 0, 0, -20, -12, -56
"/home/sanjay/Desktop/Bitbucket/MarlinV2_morphle/Marlin/src/lcd/extui/ftdi_eve_touch_ui/generic/jerk_screen.cpp", "C++", 0, -36, 0, 0, 0, -20, -9, -65
"/home/sanjay/Desktop/Bitbucket/MarlinV2_morphle/Marlin/src/lcd/extui/ftdi_eve_touch_ui/generic/jerk_screen.h", "C++", 0, -8, 0, 0, 0, -20, -5, -33
"/home/sanjay/Desktop/Bitbucket/MarlinV2_morphle/Marlin/src/lcd/extui/ftdi_eve_touch_ui/generic/junction_deviation_screen.cpp", "C++", 0, -26, 0, 0, 0, -20, -8, -54
"/home/sanjay/Desktop/Bitbucket/MarlinV2_morphle/Marlin/src/lcd/extui/ftdi_eve_touch_ui/generic/junction_deviation_screen.h", "C++", 0, -8, 0, 0, 0, -20, -5, -33
"/home/sanjay/Desktop/Bitbucket/MarlinV2_morphle/Marlin/src/lcd/extui/ftdi_eve_touch_ui/generic/kill_screen.cpp", "C++", 0, -23, 0, 0, 0, -23, -13, -59
"/home/sanjay/Desktop/Bitbucket/MarlinV2_morphle/Marlin/src/lcd/extui/ftdi_eve_touch_ui/generic/kill_screen.h", "C++", 0, -7, 0, 0, 0, -22, -5, -34
"/home/sanjay/Desktop/Bitbucket/MarlinV2_morphle/Marlin/src/lcd/extui/ftdi_eve_touch_ui/generic/language_menu.cpp", "C++", 0, -35, 0, 0, 0, -20, -12, -67
"/home/sanjay/Desktop/Bitbucket/MarlinV2_morphle/Marlin/src/lcd/extui/ftdi_eve_touch_ui/generic/language_menu.h", "C++", 0, -8, 0, 0, 0, -20, -5, -33
"/home/sanjay/Desktop/Bitbucket/MarlinV2_morphle/Marlin/src/lcd/extui/ftdi_eve_touch_ui/generic/leveling_menu.cpp", "C++", 0, -110, 0, 0, 0, -20, -11, -141
"/home/sanjay/Desktop/Bitbucket/MarlinV2_morphle/Marlin/src/lcd/extui/ftdi_eve_touch_ui/generic/leveling_menu.h", "C++", 0, -8, 0, 0, 0, -20, -5, -33
"/home/sanjay/Desktop/Bitbucket/MarlinV2_morphle/Marlin/src/lcd/extui/ftdi_eve_touch_ui/generic/linear_advance_screen.cpp", "C++", 0, -49, 0, 0, 0, -20, -8, -77
"/home/sanjay/Desktop/Bitbucket/MarlinV2_morphle/Marlin/src/lcd/extui/ftdi_eve_touch_ui/generic/linear_advance_screen.h", "C++", 0, -8, 0, 0, 0, -20, -5, -33
"/home/sanjay/Desktop/Bitbucket/MarlinV2_morphle/Marlin/src/lcd/extui/ftdi_eve_touch_ui/generic/lock_screen.cpp", "C++", 0, -141, 0, 0, 0, -32, -25, -198
"/home/sanjay/Desktop/Bitbucket/MarlinV2_morphle/Marlin/src/lcd/extui/ftdi_eve_touch_ui/generic/lock_screen.h", "C++", 0, -24, 0, 0, 0, -20, -10, -54
"/home/sanjay/Desktop/Bitbucket/MarlinV2_morphle/Marlin/src/lcd/extui/ftdi_eve_touch_ui/generic/main_menu.cpp", "C++", 0, -98, 0, 0, 0, -21, -12, -131
"/home/sanjay/Desktop/Bitbucket/MarlinV2_morphle/Marlin/src/lcd/extui/ftdi_eve_touch_ui/generic/main_menu.h", "C++", 0, -8, 0, 0, 0, -21, -5, -34
"/home/sanjay/Desktop/Bitbucket/MarlinV2_morphle/Marlin/src/lcd/extui/ftdi_eve_touch_ui/generic/max_acceleration_screen.cpp", "C++", 0, -57, 0, 0, 0, -20, -8, -85
"/home/sanjay/Desktop/Bitbucket/MarlinV2_morphle/Marlin/src/lcd/extui/ftdi_eve_touch_ui/generic/max_acceleration_screen.h", "C++", 0, -8, 0, 0, 0, -20, -5, -33
"/home/sanjay/Desktop/Bitbucket/MarlinV2_morphle/Marlin/src/lcd/extui/ftdi_eve_touch_ui/generic/max_velocity_screen.cpp", "C++", 0, -61, 0, 0, 0, -20, -8, -89
"/home/sanjay/Desktop/Bitbucket/MarlinV2_morphle/Marlin/src/lcd/extui/ftdi_eve_touch_ui/generic/max_velocity_screen.h", "C++", 0, -8, 0, 0, 0, -20, -5, -33
"/home/sanjay/Desktop/Bitbucket/MarlinV2_morphle/Marlin/src/lcd/extui/ftdi_eve_touch_ui/generic/media_player_screen.cpp", "C++", 0, -95, 0, 0, 0, -44, -29, -168
"/home/sanjay/Desktop/Bitbucket/MarlinV2_morphle/Marlin/src/lcd/extui/ftdi_eve_touch_ui/generic/media_player_screen.h", "C++", 0, -13, 0, 0, 0, -20, -8, -41
"/home/sanjay/Desktop/Bitbucket/MarlinV2_morphle/Marlin/src/lcd/extui/ftdi_eve_touch_ui/generic/move_axis_screen.cpp", "C++", 0, -99, 0, 0, 0, -28, -17, -144
"/home/sanjay/Desktop/Bitbucket/MarlinV2_morphle/Marlin/src/lcd/extui/ftdi_eve_touch_ui/generic/move_axis_screen.h", "C++", 0, -22, 0, 0, 0, -20, -8, -50
"/home/sanjay/Desktop/Bitbucket/MarlinV2_morphle/Marlin/src/lcd/extui/ftdi_eve_touch_ui/generic/nozzle_offsets_screen.cpp", "C++", 0, -41, 0, 0, 0, -22, -10, -73
"/home/sanjay/Desktop/Bitbucket/MarlinV2_morphle/Marlin/src/lcd/extui/ftdi_eve_touch_ui/generic/nozzle_offsets_screen.h", "C++", 0, -9, 0, 0, 0, -20, -5, -34
"/home/sanjay/Desktop/Bitbucket/MarlinV2_morphle/Marlin/src/lcd/extui/ftdi_eve_touch_ui/generic/nudge_nozzle_screen.cpp", "C++", 0, -86, 0, 0, 0, -20, -19, -125
"/home/sanjay/Desktop/Bitbucket/MarlinV2_morphle/Marlin/src/lcd/extui/ftdi_eve_touch_ui/generic/nudge_nozzle_screen.h", "C++", 0, -19, 0, 0, 0, -20, -6, -45
"/home/sanjay/Desktop/Bitbucket/MarlinV2_morphle/Marlin/src/lcd/extui/ftdi_eve_touch_ui/generic/restore_failsafe_dialog_box.cpp", "C++", 0, -21, 0, 0, 0, -22, -8, -51
"/home/sanjay/Desktop/Bitbucket/MarlinV2_morphle/Marlin/src/lcd/extui/ftdi_eve_touch_ui/generic/restore_failsafe_dialog_box.h", "C++", 0, -8, 0, 0, 0, -20, -5, -33
"/home/sanjay/Desktop/Bitbucket/MarlinV2_morphle/Marlin/src/lcd/extui/ftdi_eve_touch_ui/generic/save_settings_dialog_box.cpp", "C++", 0, -33, 0, 0, 0, -24, -11, -68
"/home/sanjay/Desktop/Bitbucket/MarlinV2_morphle/Marlin/src/lcd/extui/ftdi_eve_touch_ui/generic/save_settings_dialog_box.h", "C++", 0, -13, 0, 0, 0, -20, -7, -40
"/home/sanjay/Desktop/Bitbucket/MarlinV2_morphle/Marlin/src/lcd/extui/ftdi_eve_touch_ui/generic/screens.h", "C++", 0, -172, 0, 0, 0, -27, -26, -225
"/home/sanjay/Desktop/Bitbucket/MarlinV2_morphle/Marlin/src/lcd/extui/ftdi_eve_touch_ui/generic/spinner_dialog_box.cpp", "C++", 0, -72, 0, 0, 0, -20, -17, -109
"/home/sanjay/Desktop/Bitbucket/MarlinV2_morphle/Marlin/src/lcd/extui/ftdi_eve_touch_ui/generic/spinner_dialog_box.h", "C++", 0, -20, 0, 0, 0, -20, -9, -49
"/home/sanjay/Desktop/Bitbucket/MarlinV2_morphle/Marlin/src/lcd/extui/ftdi_eve_touch_ui/generic/statistics_screen.cpp", "C++", 0, -44, 0, 0, 0, -21, -13, -78
"/home/sanjay/Desktop/Bitbucket/MarlinV2_morphle/Marlin/src/lcd/extui/ftdi_eve_touch_ui/generic/statistics_screen.h", "C++", 0, -8, 0, 0, 0, -20, -5, -33
"/home/sanjay/Desktop/Bitbucket/MarlinV2_morphle/Marlin/src/lcd/extui/ftdi_eve_touch_ui/generic/status_screen.cpp", "C++", 0, -369, 0, 0, 0, -27, -71, -467
"/home/sanjay/Desktop/Bitbucket/MarlinV2_morphle/Marlin/src/lcd/extui/ftdi_eve_touch_ui/generic/status_screen.h", "C++", 0, -23, 0, 0, 0, -20, -5, -48
"/home/sanjay/Desktop/Bitbucket/MarlinV2_morphle/Marlin/src/lcd/extui/ftdi_eve_touch_ui/generic/stepper_bump_sensitivity_screen.cpp", "C++", 0, -31, 0, 0, 0, -20, -8, -59
"/home/sanjay/Desktop/Bitbucket/MarlinV2_morphle/Marlin/src/lcd/extui/ftdi_eve_touch_ui/generic/stepper_bump_sensitivity_screen.h", "C++", 0, -8, 0, 0, 0, -20, -5, -33
"/home/sanjay/Desktop/Bitbucket/MarlinV2_morphle/Marlin/src/lcd/extui/ftdi_eve_touch_ui/generic/stepper_current_screen.cpp", "C++", 0, -99, 0, 0, 0, -20, -8, -127
"/home/sanjay/Desktop/Bitbucket/MarlinV2_morphle/Marlin/src/lcd/extui/ftdi_eve_touch_ui/generic/stepper_current_screen.h", "C++", 0, -8, 0, 0, 0, -20, -5, -33
"/home/sanjay/Desktop/Bitbucket/MarlinV2_morphle/Marlin/src/lcd/extui/ftdi_eve_touch_ui/generic/steps_screen.cpp", "C++", 0, -58, 0, 0, 0, -20, -8, -86
"/home/sanjay/Desktop/Bitbucket/MarlinV2_morphle/Marlin/src/lcd/extui/ftdi_eve_touch_ui/generic/steps_screen.h", "C++", 0, -8, 0, 0, 0, -20, -5, -33
"/home/sanjay/Desktop/Bitbucket/MarlinV2_morphle/Marlin/src/lcd/extui/ftdi_eve_touch_ui/generic/stress_test_screen.cpp", "C++", 0, -98, 0, 0, 0, -24, -27, -149
"/home/sanjay/Desktop/Bitbucket/MarlinV2_morphle/Marlin/src/lcd/extui/ftdi_eve_touch_ui/generic/stress_test_screen.h", "C++", 0, -21, 0, 0, 0, -20, -8, -49
"/home/sanjay/Desktop/Bitbucket/MarlinV2_morphle/Marlin/src/lcd/extui/ftdi_eve_touch_ui/generic/string_format.cpp", "C++", 0, -74, 0, 0, 0, -28, -9, -111
"/home/sanjay/Desktop/Bitbucket/MarlinV2_morphle/Marlin/src/lcd/extui/ftdi_eve_touch_ui/generic/string_format.h", "C++", 0, -7, 0, 0, 0, -19, -4, -30
"/home/sanjay/Desktop/Bitbucket/MarlinV2_morphle/Marlin/src/lcd/extui/ftdi_eve_touch_ui/generic/temperature_screen.cpp", "C++", 0, -86, 0, 0, 0, -20, -8, -114
"/home/sanjay/Desktop/Bitbucket/MarlinV2_morphle/Marlin/src/lcd/extui/ftdi_eve_touch_ui/generic/temperature_screen.h", "C++", 0, -8, 0, 0, 0, -20, -5, -33
"/home/sanjay/Desktop/Bitbucket/MarlinV2_morphle/Marlin/src/lcd/extui/ftdi_eve_touch_ui/generic/touch_calibration_screen.cpp", "C++", 0, -50, 0, 0, 0, -27, -17, -94
"/home/sanjay/Desktop/Bitbucket/MarlinV2_morphle/Marlin/src/lcd/extui/ftdi_eve_touch_ui/generic/touch_calibration_screen.h", "C++", 0, -10, 0, 0, 0, -20, -5, -35
"/home/sanjay/Desktop/Bitbucket/MarlinV2_morphle/Marlin/src/lcd/extui/ftdi_eve_touch_ui/generic/touch_registers_screen.cpp", "C++", 0, -51, 0, 0, 0, -20, -14, -85
"/home/sanjay/Desktop/Bitbucket/MarlinV2_morphle/Marlin/src/lcd/extui/ftdi_eve_touch_ui/generic/touch_registers_screen.h", "C++", 0, -8, 0, 0, 0, -20, -5, -33
"/home/sanjay/Desktop/Bitbucket/MarlinV2_morphle/Marlin/src/lcd/extui/ftdi_eve_touch_ui/generic/tune_menu.cpp", "C++", 0, -121, 0, 0, 0, -20, -15, -156
"/home/sanjay/Desktop/Bitbucket/MarlinV2_morphle/Marlin/src/lcd/extui/ftdi_eve_touch_ui/generic/tune_menu.h", "C++", 0, -11, 0, 0, 0, -20, -5, -36
"/home/sanjay/Desktop/Bitbucket/MarlinV2_morphle/Marlin/src/lcd/extui/ftdi_eve_touch_ui/generic/widget_demo_screen.cpp", "C++", 0, -121, 0, 0, 0, -20, -17, -158
"/home/sanjay/Desktop/Bitbucket/MarlinV2_morphle/Marlin/src/lcd/extui/ftdi_eve_touch_ui/generic/widget_demo_screen.h", "C++", 0, -10, 0, 0, 0, -20, -5, -35
"/home/sanjay/Desktop/Bitbucket/MarlinV2_morphle/Marlin/src/lcd/extui/ftdi_eve_touch_ui/generic/z_offset_screen.cpp", "C++", 0, -69, 0, 0, 0, -27, -16, -112
"/home/sanjay/Desktop/Bitbucket/MarlinV2_morphle/Marlin/src/lcd/extui/ftdi_eve_touch_ui/generic/z_offset_screen.h", "C++", 0, -18, 0, 0, 0, -20, -6, -44
"/home/sanjay/Desktop/Bitbucket/MarlinV2_morphle/Marlin/src/lcd/extui/ftdi_eve_touch_ui/language/language.cpp", "C++", 0, -5, 0, 0, 0, -19, -4, -28
"/home/sanjay/Desktop/Bitbucket/MarlinV2_morphle/Marlin/src/lcd/extui/ftdi_eve_touch_ui/language/language.h", "C++", 0, -3, 0, 0, 0, -19, -4, -26
"/home/sanjay/Desktop/Bitbucket/MarlinV2_morphle/Marlin/src/lcd/extui/ftdi_eve_touch_ui/language/language_en.h", "C++", 0, -148, 0, 0, 0, -19, -11, -178
"/home/sanjay/Desktop/Bitbucket/MarlinV2_morphle/Marlin/src/lcd/extui/ftdi_eve_touch_ui/pin_mappings.h", "C++", 0, -41, 0, 0, 0, -80, -24, -145
"/home/sanjay/Desktop/Bitbucket/MarlinV2_morphle/Marlin/src/lcd/extui/ftdi_eve_touch_ui/screen_data.h", "C++", 0, -24, 0, 0, 0, -38, -8, -70
"/home/sanjay/Desktop/Bitbucket/MarlinV2_morphle/Marlin/src/lcd/extui/ftdi_eve_touch_ui/screens.cpp", "C++", 0, -80, 0, 0, 0, -37, -10, -127
"/home/sanjay/Desktop/Bitbucket/MarlinV2_morphle/Marlin/src/lcd/extui/ftdi_eve_touch_ui/screens.h", "C++", 0, -21, 0, 0, 0, -20, -10, -51
"/home/sanjay/Desktop/Bitbucket/MarlinV2_morphle/Marlin/src/lcd/extui/ftdi_eve_touch_ui/theme/bitmaps.h", "C++", 0, -221, 0, 0, 0, -20, -19, -260
"/home/sanjay/Desktop/Bitbucket/MarlinV2_morphle/Marlin/src/lcd/extui/ftdi_eve_touch_ui/theme/bootscreen_logo_portrait.h", "C++", 0, -15, 0, 0, 0, -21, -6, -42
"/home/sanjay/Desktop/Bitbucket/MarlinV2_morphle/Marlin/src/lcd/extui/ftdi_eve_touch_ui/theme/colors.h", "C++", 0, -134, 0, 0, 0, -30, -30, -194
"/home/sanjay/Desktop/Bitbucket/MarlinV2_morphle/Marlin/src/lcd/extui/ftdi_eve_touch_ui/theme/fonts.h", "C++", 0, -57, 0, 0, 0, -20, -4, -81
"/home/sanjay/Desktop/Bitbucket/MarlinV2_morphle/Marlin/src/lcd/extui/ftdi_eve_touch_ui/theme/marlin_bootscreen_landscape.h", "C++", 0, -11, 0, 0, 0, -21, -7, -39
"/home/sanjay/Desktop/Bitbucket/MarlinV2_morphle/Marlin/src/lcd/extui/ftdi_eve_touch_ui/theme/marlin_bootscreen_portrait.h", "C++", 0, -11, 0, 0, 0, -21, -7, -39
"/home/sanjay/Desktop/Bitbucket/MarlinV2_morphle/Marlin/src/lcd/extui/ftdi_eve_touch_ui/theme/sounds.cpp", "C++", 0, -323, 0, 0, 0, -21, -67, -411
"/home/sanjay/Desktop/Bitbucket/MarlinV2_morphle/Marlin/src/lcd/extui/ftdi_eve_touch_ui/theme/sounds.h", "C++", 0, -19, 0, 0, 0, -20, -5, -44
"/home/sanjay/Desktop/Bitbucket/MarlinV2_morphle/Marlin/src/lcd/extui/ftdi_eve_touch_ui/theme/theme.h", "C++", 0, -5, 0, 0, 0, -20, -4, -29
"/home/sanjay/Desktop/Bitbucket/MarlinV2_morphle/Marlin/src/lcd/extui/malyan/malyan.cpp", "C++", 0, -226, 0, 0, 0, -148, -48, -422
"/home/sanjay/Desktop/Bitbucket/MarlinV2_morphle/Marlin/src/lcd/extui/malyan/malyan.h", "C++", 0, -17, 0, 0, 0, -26, -11, -54
"/home/sanjay/Desktop/Bitbucket/MarlinV2_morphle/Marlin/src/lcd/extui/malyan/malyan_extui.cpp", "C++", 0, -88, 0, 0, 0, -55, -26, -169
"/home/sanjay/Desktop/Bitbucket/MarlinV2_morphle/Marlin/src/lcd/extui/mks_ui/SPIFlashStorage.cpp", "C++", 0, -205, 0, 0, 0, -77, -40, -322
"/home/sanjay/Desktop/Bitbucket/MarlinV2_morphle/Marlin/src/lcd/extui/mks_ui/SPIFlashStorage.h", "C++", 0, -30, 0, 0, 0, -70, -9, -109
"/home/sanjay/Desktop/Bitbucket/MarlinV2_morphle/Marlin/src/lcd/extui/mks_ui/SPI_TFT.cpp", "C++", 0, -49, 0, 0, 0, -22, -16, -87
"/home/sanjay/Desktop/Bitbucket/MarlinV2_morphle/Marlin/src/lcd/extui/mks_ui/SPI_TFT.h", "C++", 0, -14, 0, 0, 0, -21, -4, -39
"/home/sanjay/Desktop/Bitbucket/MarlinV2_morphle/Marlin/src/lcd/extui/mks_ui/draw_about.cpp", "C++", 0, -32, 0, 0, 0, -21, -13, -66
"/home/sanjay/Desktop/Bitbucket/MarlinV2_morphle/Marlin/src/lcd/extui/mks_ui/draw_about.h", "C++", 0, -9, 0, 0, 0, -21, -4, -34
"/home/sanjay/Desktop/Bitbucket/MarlinV2_morphle/Marlin/src/lcd/extui/mks_ui/draw_acceleration_settings.cpp", "C++", 0, -129, 0, 0, 0, -21, -20, -170
"/home/sanjay/Desktop/Bitbucket/MarlinV2_morphle/Marlin/src/lcd/extui/mks_ui/draw_acceleration_settings.h", "C++", 0, -9, 0, 0, 0, -21, -4, -34
"/home/sanjay/Desktop/Bitbucket/MarlinV2_morphle/Marlin/src/lcd/extui/mks_ui/draw_advance_settings.cpp", "C++", 0, -64, 0, 0, 0, -21, -13, -98
"/home/sanjay/Desktop/Bitbucket/MarlinV2_morphle/Marlin/src/lcd/extui/mks_ui/draw_advance_settings.h", "C++", 0, -9, 0, 0, 0, -21, -4, -34
"/home/sanjay/Desktop/Bitbucket/MarlinV2_morphle/Marlin/src/lcd/extui/mks_ui/draw_auto_level_offset_settings.cpp", "C++", 0, -55, 0, 0, 0, -21, -15, -91
"/home/sanjay/Desktop/Bitbucket/MarlinV2_morphle/Marlin/src/lcd/extui/mks_ui/draw_auto_level_offset_settings.h", "C++", 0, -9, 0, 0, 0, -21, -4, -34
"/home/sanjay/Desktop/Bitbucket/MarlinV2_morphle/Marlin/src/lcd/extui/mks_ui/draw_baby_stepping.cpp", "C++", 0, -139, 0, 0, 0, -21, -21, -181
"/home/sanjay/Desktop/Bitbucket/MarlinV2_morphle/Marlin/src/lcd/extui/mks_ui/draw_baby_stepping.h", "C++", 0, -11, 0, 0, 0, -21, -4, -36
"/home/sanjay/Desktop/Bitbucket/MarlinV2_morphle/Marlin/src/lcd/extui/mks_ui/draw_change_speed.cpp", "C++", 0, -179, 0, 0, 0, -23, -24, -226
"/home/sanjay/Desktop/Bitbucket/MarlinV2_morphle/Marlin/src/lcd/extui/mks_ui/draw_change_speed.h", "C++", 0, -14, 0, 0, 0, -21, -5, -40
"/home/sanjay/Desktop/Bitbucket/MarlinV2_morphle/Marlin/src/lcd/extui/mks_ui/draw_cloud_bind.cpp", "C++", 0, -152, 0, 0, 0, -21, -33, -206
"/home/sanjay/Desktop/Bitbucket/MarlinV2_morphle/Marlin/src/lcd/extui/mks_ui/draw_cloud_bind.h", "C++", 0, -13, 0, 0, 0, -21, -4, -38
"/home/sanjay/Desktop/Bitbucket/MarlinV2_morphle/Marlin/src/lcd/extui/mks_ui/draw_dialog.cpp", "C++", 0, -485, 0, 0, 0, -27, -44, -556
"/home/sanjay/Desktop/Bitbucket/MarlinV2_morphle/Marlin/src/lcd/extui/mks_ui/draw_dialog.h", "C++", 0, -51, 0, 0, 0, -21, -14, -86
"/home/sanjay/Desktop/Bitbucket/MarlinV2_morphle/Marlin/src/lcd/extui/mks_ui/draw_eeprom_settings.cpp", "C++", 0, -52, 0, 0, 0, -21, -11, -84
"/home/sanjay/Desktop/Bitbucket/MarlinV2_morphle/Marlin/src/lcd/extui/mks_ui/draw_eeprom_settings.h", "C++", 0, -9, 0, 0, 0, -21, -4, -34
"/home/sanjay/Desktop/Bitbucket/MarlinV2_morphle/Marlin/src/lcd/extui/mks_ui/draw_encoder_settings.cpp", "C++", 0, -40, 0, 0, 0, -21, -13, -74
"/home/sanjay/Desktop/Bitbucket/MarlinV2_morphle/Marlin/src/lcd/extui/mks_ui/draw_encoder_settings.h", "C++", 0, -9, 0, 0, 0, -21, -4, -34
"/home/sanjay/Desktop/Bitbucket/MarlinV2_morphle/Marlin/src/lcd/extui/mks_ui/draw_error_message.cpp", "C++", 0, -18, 0, 0, 0, -21, -8, -47
"/home/sanjay/Desktop/Bitbucket/MarlinV2_morphle/Marlin/src/lcd/extui/mks_ui/draw_error_message.h", "C++", 0, -12, 0, 0, 0, -21, -5, -38
"/home/sanjay/Desktop/Bitbucket/MarlinV2_morphle/Marlin/src/lcd/extui/mks_ui/draw_extrusion.cpp", "C++", 0, -183, 0, 0, 0, -23, -31, -237
"/home/sanjay/Desktop/Bitbucket/MarlinV2_morphle/Marlin/src/lcd/extui/mks_ui/draw_extrusion.h", "C++", 0, -14, 0, 0, 0, -21, -4, -39
"/home/sanjay/Desktop/Bitbucket/MarlinV2_morphle/Marlin/src/lcd/extui/mks_ui/draw_fan.cpp", "C++", 0, -64, 0, 0, 0, -22, -14, -100
"/home/sanjay/Desktop/Bitbucket/MarlinV2_morphle/Marlin/src/lcd/extui/mks_ui/draw_fan.h", "C++", 0, -10, 0, 0, 0, -21, -4, -35
"/home/sanjay/Desktop/Bitbucket/MarlinV2_morphle/Marlin/src/lcd/extui/mks_ui/draw_filament_change.cpp", "C++", 0, -128, 0, 0, 0, -23, -22, -173
"/home/sanjay/Desktop/Bitbucket/MarlinV2_morphle/Marlin/src/lcd/extui/mks_ui/draw_filament_change.h", "C++", 0, -11, 0, 0, 0, -21, -4, -36
"/home/sanjay/Desktop/Bitbucket/MarlinV2_morphle/Marlin/src/lcd/extui/mks_ui/draw_filament_settings.cpp", "C++", 0, -89, 0, 0, 0, -21, -18, -128
"/home/sanjay/Desktop/Bitbucket/MarlinV2_morphle/Marlin/src/lcd/extui/mks_ui/draw_filament_settings.h", "C++", 0, -9, 0, 0, 0, -21, -4, -34
"/home/sanjay/Desktop/Bitbucket/MarlinV2_morphle/Marlin/src/lcd/extui/mks_ui/draw_gcode.cpp", "C++", 0, -69, 0, 0, 0, -24, -16, -109
"/home/sanjay/Desktop/Bitbucket/MarlinV2_morphle/Marlin/src/lcd/extui/mks_ui/draw_gcode.h", "C++", 0, -9, 0, 0, 0, -21, -4, -34
"/home/sanjay/Desktop/Bitbucket/MarlinV2_morphle/Marlin/src/lcd/extui/mks_ui/draw_home.cpp", "C++", 0, -62, 0, 0, 0, -21, -11, -94
"/home/sanjay/Desktop/Bitbucket/MarlinV2_morphle/Marlin/src/lcd/extui/mks_ui/draw_home.h", "C++", 0, -9, 0, 0, 0, -21, -4, -34
"/home/sanjay/Desktop/Bitbucket/MarlinV2_morphle/Marlin/src/lcd/extui/mks_ui/draw_homing_sensitivity_settings.cpp", "C++", 0, -69, 0, 0, 0, -21, -16, -106
"/home/sanjay/Desktop/Bitbucket/MarlinV2_morphle/Marlin/src/lcd/extui/mks_ui/draw_homing_sensitivity_settings.h", "C++", 0, -9, 0, 0, 0, -21, -4, -34
"/home/sanjay/Desktop/Bitbucket/MarlinV2_morphle/Marlin/src/lcd/extui/mks_ui/draw_jerk_settings.cpp", "C++", 0, -63, 0, 0, 0, -21, -16, -100
"/home/sanjay/Desktop/Bitbucket/MarlinV2_morphle/Marlin/src/lcd/extui/mks_ui/draw_jerk_settings.h", "C++", 0, -9, 0, 0, 0, -21, -4, -34
"/home/sanjay/Desktop/Bitbucket/MarlinV2_morphle/Marlin/src/lcd/extui/mks_ui/draw_keyboard.cpp", "C++", 0, -208, 0, 0, 0, -31, -34, -273
"/home/sanjay/Desktop/Bitbucket/MarlinV2_morphle/Marlin/src/lcd/extui/mks_ui/draw_keyboard.h", "C++", 0, -9, 0, 0, 0, -21, -4, -34
"/home/sanjay/Desktop/Bitbucket/MarlinV2_morphle/Marlin/src/lcd/extui/mks_ui/draw_language.cpp", "C++", 0, -168, 0, 0, 0, -22, -20, -210
"/home/sanjay/Desktop/Bitbucket/MarlinV2_morphle/Marlin/src/lcd/extui/mks_ui/draw_language.h", "C++", 0, -9, 0, 0, 0, -21, -4, -34
"/home/sanjay/Desktop/Bitbucket/MarlinV2_morphle/Marlin/src/lcd/extui/mks_ui/draw_level_settings.cpp", "C++", 0, -59, 0, 0, 0, -21, -11, -91
"/home/sanjay/Desktop/Bitbucket/MarlinV2_morphle/Marlin/src/lcd/extui/mks_ui/draw_level_settings.h", "C++", 0, -9, 0, 0, 0, -21, -4, -34
"/home/sanjay/Desktop/Bitbucket/MarlinV2_morphle/Marlin/src/lcd/extui/mks_ui/draw_machine_para.cpp", "C++", 0, -54, 0, 0, 0, -21, -11, -86
"/home/sanjay/Desktop/Bitbucket/MarlinV2_morphle/Marlin/src/lcd/extui/mks_ui/draw_machine_para.h", "C++", 0, -9, 0, 0, 0, -21, -4, -34
"/home/sanjay/Desktop/Bitbucket/MarlinV2_morphle/Marlin/src/lcd/extui/mks_ui/draw_machine_settings.cpp", "C++", 0, -44, 0, 0, 0, -21, -11, -76
"/home/sanjay/Desktop/Bitbucket/MarlinV2_morphle/Marlin/src/lcd/extui/mks_ui/draw_machine_settings.h", "C++", 0, -9, 0, 0, 0, -21, -4, -34
"/home/sanjay/Desktop/Bitbucket/MarlinV2_morphle/Marlin/src/lcd/extui/mks_ui/draw_manuaLevel.cpp", "C++", 0, -54, 0, 0, 0, -22, -13, -89
"/home/sanjay/Desktop/Bitbucket/MarlinV2_morphle/Marlin/src/lcd/extui/mks_ui/draw_manuaLevel.h", "C++", 0, -9, 0, 0, 0, -21, -4, -34
"/home/sanjay/Desktop/Bitbucket/MarlinV2_morphle/Marlin/src/lcd/extui/mks_ui/draw_max_feedrate_settings.cpp", "C++", 0, -79, 0, 0, 0, -21, -19, -119
"/home/sanjay/Desktop/Bitbucket/MarlinV2_morphle/Marlin/src/lcd/extui/mks_ui/draw_max_feedrate_settings.h", "C++", 0, -9, 0, 0, 0, -21, -4, -34
"/home/sanjay/Desktop/Bitbucket/MarlinV2_morphle/Marlin/src/lcd/extui/mks_ui/draw_media_select.cpp", "C++", 0, -42, 0, 0, 0, -21, -11, -74
"/home/sanjay/Desktop/Bitbucket/MarlinV2_morphle/Marlin/src/lcd/extui/mks_ui/draw_media_select.h", "C++", 0, -9, 0, 0, 0, -21, -4, -34
"/home/sanjay/Desktop/Bitbucket/MarlinV2_morphle/Marlin/src/lcd/extui/mks_ui/draw_more.cpp", "C++", 0, -161, 0, 0, 0, -21, -22, -204
"/home/sanjay/Desktop/Bitbucket/MarlinV2_morphle/Marlin/src/lcd/extui/mks_ui/draw_more.h", "C++", 0, -9, 0, 0, 0, -21, -4, -34
"/home/sanjay/Desktop/Bitbucket/MarlinV2_morphle/Marlin/src/lcd/extui/mks_ui/draw_motor_settings.cpp", "C++", 0, -66, 0, 0, 0, -21, -13, -100
"/home/sanjay/Desktop/Bitbucket/MarlinV2_morphle/Marlin/src/lcd/extui/mks_ui/draw_motor_settings.h", "C++", 0, -9, 0, 0, 0, -21, -4, -34
"/home/sanjay/Desktop/Bitbucket/MarlinV2_morphle/Marlin/src/lcd/extui/mks_ui/draw_move_motor.cpp", "C++", 0, -121, 0, 0, 0, -23, -21, -165
"/home/sanjay/Desktop/Bitbucket/MarlinV2_morphle/Marlin/src/lcd/extui/mks_ui/draw_move_motor.h", "C++", 0, -10, 0, 0, 0, -21, -4, -35
"/home/sanjay/Desktop/Bitbucket/MarlinV2_morphle/Marlin/src/lcd/extui/mks_ui/draw_number_key.cpp", "C++", 0, -478, 0, 0, 0, -21, -41, -540
"/home/sanjay/Desktop/Bitbucket/MarlinV2_morphle/Marlin/src/lcd/extui/mks_ui/draw_number_key.h", "C++", 0, -9, 0, 0, 0, -21, -4, -34
"/home/sanjay/Desktop/Bitbucket/MarlinV2_morphle/Marlin/src/lcd/extui/mks_ui/draw_operation.cpp", "C++", 0, -179, 0, 0, 0, -23, -28, -230
"/home/sanjay/Desktop/Bitbucket/MarlinV2_morphle/Marlin/src/lcd/extui/mks_ui/draw_operation.h", "C++", 0, -9, 0, 0, 0, -21, -4, -34
"/home/sanjay/Desktop/Bitbucket/MarlinV2_morphle/Marlin/src/lcd/extui/mks_ui/draw_pause_message.cpp", "C++", 0, -25, 0, 0, 0, -21, -7, -53
"/home/sanjay/Desktop/Bitbucket/MarlinV2_morphle/Marlin/src/lcd/extui/mks_ui/draw_pause_message.h", "C++", 0, -8, 0, 0, 0, -21, -4, -33
"/home/sanjay/Desktop/Bitbucket/MarlinV2_morphle/Marlin/src/lcd/extui/mks_ui/draw_pause_position.cpp", "C++", 0, -50, 0, 0, 0, -21, -15, -86
"/home/sanjay/Desktop/Bitbucket/MarlinV2_morphle/Marlin/src/lcd/extui/mks_ui/draw_pause_position.h", "C++", 0, -9, 0, 0, 0, -21, -4, -34
"/home/sanjay/Desktop/Bitbucket/MarlinV2_morphle/Marlin/src/lcd/extui/mks_ui/draw_preHeat.cpp", "C++", 0, -265, 0, 0, 0, -24, -30, -319
"/home/sanjay/Desktop/Bitbucket/MarlinV2_morphle/Marlin/src/lcd/extui/mks_ui/draw_preHeat.h", "C++", 0, -14, 0, 0, 0, -21, -4, -39
"/home/sanjay/Desktop/Bitbucket/MarlinV2_morphle/Marlin/src/lcd/extui/mks_ui/draw_print_file.cpp", "C++", 0, -412, 0, 0, 0, -76, -68, -556
"/home/sanjay/Desktop/Bitbucket/MarlinV2_morphle/Marlin/src/lcd/extui/mks_ui/draw_print_file.h", "C++", 0, -36, 0, 0, 0, -21, -8, -65
"/home/sanjay/Desktop/Bitbucket/MarlinV2_morphle/Marlin/src/lcd/extui/mks_ui/draw_printing.cpp", "C++", 0, -255, 0, 0, 0, -22, -51, -328
"/home/sanjay/Desktop/Bitbucket/MarlinV2_morphle/Marlin/src/lcd/extui/mks_ui/draw_printing.h", "C++", 0, -28, 0, 0, 0, -21, -5, -54
"/home/sanjay/Desktop/Bitbucket/MarlinV2_morphle/Marlin/src/lcd/extui/mks_ui/draw_ready_print.cpp", "C++", 0, -188, 0, 0, 0, -24, -38, -250
"/home/sanjay/Desktop/Bitbucket/MarlinV2_morphle/Marlin/src/lcd/extui/mks_ui/draw_ready_print.h", "C++", 0, -15, 0, 0, 0, -21, -4, -40
"/home/sanjay/Desktop/Bitbucket/MarlinV2_morphle/Marlin/src/lcd/extui/mks_ui/draw_set.cpp", "C++", 0, -102, 0, 0, 0, -21, -14, -137
"/home/sanjay/Desktop/Bitbucket/MarlinV2_morphle/Marlin/src/lcd/extui/mks_ui/draw_set.h", "C++", 0, -9, 0, 0, 0, -21, -4, -34
"/home/sanjay/Desktop/Bitbucket/MarlinV2_morphle/Marlin/src/lcd/extui/mks_ui/draw_step_settings.cpp", "C++", 0, -79, 0, 0, 0, -21, -18, -118
"/home/sanjay/Desktop/Bitbucket/MarlinV2_morphle/Marlin/src/lcd/extui/mks_ui/draw_step_settings.h", "C++", 0, -9, 0, 0, 0, -21, -4, -34
"/home/sanjay/Desktop/Bitbucket/MarlinV2_morphle/Marlin/src/lcd/extui/mks_ui/draw_tmc_current_settings.cpp", "C++", 0, -106, 0, 0, 0, -21, -20, -147
"/home/sanjay/Desktop/Bitbucket/MarlinV2_morphle/Marlin/src/lcd/extui/mks_ui/draw_tmc_current_settings.h", "C++", 0, -9, 0, 0, 0, -21, -4, -34
"/home/sanjay/Desktop/Bitbucket/MarlinV2_morphle/Marlin/src/lcd/extui/mks_ui/draw_tmc_step_mode_settings.cpp", "C++", 0, -93, 0, 0, 0, -21, -22, -136
"/home/sanjay/Desktop/Bitbucket/MarlinV2_morphle/Marlin/src/lcd/extui/mks_ui/draw_tmc_step_mode_settings.h", "C++", 0, -9, 0, 0, 0, -21, -4, -34
"/home/sanjay/Desktop/Bitbucket/MarlinV2_morphle/Marlin/src/lcd/extui/mks_ui/draw_tool.cpp", "C++", 0, -72, 0, 0, 0, -21, -12, -105
"/home/sanjay/Desktop/Bitbucket/MarlinV2_morphle/Marlin/src/lcd/extui/mks_ui/draw_tool.h", "C++", 0, -9, 0, 0, 0, -21, -4, -34
"/home/sanjay/Desktop/Bitbucket/MarlinV2_morphle/Marlin/src/lcd/extui/mks_ui/draw_touch_calibration.cpp", "C++", 0, -75, 0, 0, 0, -26, -22, -123
"/home/sanjay/Desktop/Bitbucket/MarlinV2_morphle/Marlin/src/lcd/extui/mks_ui/draw_touch_calibration.h", "C++", 0, -10, 0, 0, 0, -21, -4, -35
"/home/sanjay/Desktop/Bitbucket/MarlinV2_morphle/Marlin/src/lcd/extui/mks_ui/draw_tramming_pos_settings.cpp", "C++", 0, -107, 0, 0, 0, -21, -19, -147
"/home/sanjay/Desktop/Bitbucket/MarlinV2_morphle/Marlin/src/lcd/extui/mks_ui/draw_tramming_pos_settings.h", "C++", 0, -9, 0, 0, 0, -21, -4, -34
"/home/sanjay/Desktop/Bitbucket/MarlinV2_morphle/Marlin/src/lcd/extui/mks_ui/draw_ui.cpp", "C++", 0, -1175, 0, 0, 0, -49, -172, -1396
"/home/sanjay/Desktop/Bitbucket/MarlinV2_morphle/Marlin/src/lcd/extui/mks_ui/draw_ui.h", "C++", 0, -426, 0, 0, 0, -46, -81, -553
"/home/sanjay/Desktop/Bitbucket/MarlinV2_morphle/Marlin/src/lcd/extui/mks_ui/draw_wifi.cpp", "C++", 0, -118, 0, 0, 0, -22, -28, -168
"/home/sanjay/Desktop/Bitbucket/MarlinV2_morphle/Marlin/src/lcd/extui/mks_ui/draw_wifi.h", "C++", 0, -10, 0, 0, 0, -21, -5, -36
"/home/sanjay/Desktop/Bitbucket/MarlinV2_morphle/Marlin/src/lcd/extui/mks_ui/draw_wifi_list.cpp", "C++", 0, -129, 0, 0, 0, -21, -29, -179
"/home/sanjay/Desktop/Bitbucket/MarlinV2_morphle/Marlin/src/lcd/extui/mks_ui/draw_wifi_list.h", "C++", 0, -46, 0, 0, 0, -21, -10, -77
"/home/sanjay/Desktop/Bitbucket/MarlinV2_morphle/Marlin/src/lcd/extui/mks_ui/draw_wifi_settings.cpp", "C++", 0, -137, 0, 0, 0, -21, -31, -189
"/home/sanjay/Desktop/Bitbucket/MarlinV2_morphle/Marlin/src/lcd/extui/mks_ui/draw_wifi_settings.h", "C++", 0, -11, 0, 0, 0, -21, -5, -37
"/home/sanjay/Desktop/Bitbucket/MarlinV2_morphle/Marlin/src/lcd/extui/mks_ui/draw_wifi_tips.cpp", "C++", 0, -34, 0, 0, 0, -21, -15, -70
"/home/sanjay/Desktop/Bitbucket/MarlinV2_morphle/Marlin/src/lcd/extui/mks_ui/draw_wifi_tips.h", "C++", 0, -22, 0, 0, 0, -21, -8, -51
"/home/sanjay/Desktop/Bitbucket/MarlinV2_morphle/Marlin/src/lcd/extui/mks_ui/draw_z_offset_wizard.cpp", "C++", 0, -162, 0, 0, 0, -32, -35, -229
"/home/sanjay/Desktop/Bitbucket/MarlinV2_morphle/Marlin/src/lcd/extui/mks_ui/draw_z_offset_wizard.h", "C++", 0, -12, 0, 0, 0, -21, -4, -37
"/home/sanjay/Desktop/Bitbucket/MarlinV2_morphle/Marlin/src/lcd/extui/mks_ui/gb2312_puhui16.cpp", "C++", 0, -71, 0, 0, 0, -21, -15, -107
"/home/sanjay/Desktop/Bitbucket/MarlinV2_morphle/Marlin/src/lcd/extui/mks_ui/irq_overrid.cpp", "C++", 0, -27, 0, 0, 0, -21, -13, -61
"/home/sanjay/Desktop/Bitbucket/MarlinV2_morphle/Marlin/src/lcd/extui/mks_ui/mks_hardware.cpp", "C++", 0, -583, 0, 0, 0, -117, -37, -737
"/home/sanjay/Desktop/Bitbucket/MarlinV2_morphle/Marlin/src/lcd/extui/mks_ui/mks_hardware.h", "C++", 0, -15, 0, 0, 0, -23, -5, -43
"/home/sanjay/Desktop/Bitbucket/MarlinV2_morphle/Marlin/src/lcd/extui/mks_ui/pic_manager.cpp", "C++", 0, -499, 0, 0, 0, -46, -82, -627
"/home/sanjay/Desktop/Bitbucket/MarlinV2_morphle/Marlin/src/lcd/extui/mks_ui/pic_manager.h", "C++", 0, -105, 0, 0, 0, -34, -30, -169
"/home/sanjay/Desktop/Bitbucket/MarlinV2_morphle/Marlin/src/lcd/extui/mks_ui/printer_operation.cpp", "C++", 0, -163, 0, 0, 0, -23, -29, -215
"/home/sanjay/Desktop/Bitbucket/MarlinV2_morphle/Marlin/src/lcd/extui/mks_ui/printer_operation.h", "C++", 0, -11, 0, 0, 0, -21, -5, -37
"/home/sanjay/Desktop/Bitbucket/MarlinV2_morphle/Marlin/src/lcd/extui/mks_ui/tft_Language_en.h", "C++", 0, -596, 0, 0, 0, -47, -98, -741
"/home/sanjay/Desktop/Bitbucket/MarlinV2_morphle/Marlin/src/lcd/extui/mks_ui/tft_Language_fr.h", "C++", 0, -217, 0, 0, 0, -22, -30, -269
"/home/sanjay/Desktop/Bitbucket/MarlinV2_morphle/Marlin/src/lcd/extui/mks_ui/tft_Language_it.h", "C++", 0, -217, 0, 0, 0, -22, -27, -266
"/home/sanjay/Desktop/Bitbucket/MarlinV2_morphle/Marlin/src/lcd/extui/mks_ui/tft_Language_ru.h", "C++", 0, -298, 0, 0, 0, -22, -43, -363
"/home/sanjay/Desktop/Bitbucket/MarlinV2_morphle/Marlin/src/lcd/extui/mks_ui/tft_Language_s_cn.h", "C++", 0, -420, 0, 0, 0, -22, -62, -504
"/home/sanjay/Desktop/Bitbucket/MarlinV2_morphle/Marlin/src/lcd/extui/mks_ui/tft_Language_sp.h", "C++", 0, -222, 0, 0, 0, -22, -29, -273
"/home/sanjay/Desktop/Bitbucket/MarlinV2_morphle/Marlin/src/lcd/extui/mks_ui/tft_Language_t_cn.h", "C++", 0, -419, 0, 0, 0, -22, -61, -502
"/home/sanjay/Desktop/Bitbucket/MarlinV2_morphle/Marlin/src/lcd/extui/mks_ui/tft_lvgl_configuration.cpp", "C++", 0, -447, 0, 0, 0, -28, -94, -569
"/home/sanjay/Desktop/Bitbucket/MarlinV2_morphle/Marlin/src/lcd/extui/mks_ui/tft_lvgl_configuration.h", "C++", 0, -33, 0, 0, 0, -26, -13, -72
"/home/sanjay/Desktop/Bitbucket/MarlinV2_morphle/Marlin/src/lcd/extui/mks_ui/tft_multi_language.cpp", "C++", 0, -2458, 0, 0, 0, -191, -204, -2853
"/home/sanjay/Desktop/Bitbucket/MarlinV2_morphle/Marlin/src/lcd/extui/mks_ui/tft_multi_language.h", "C++", 0, -701, 0, 0, 0, -23, -125, -849
"/home/sanjay/Desktop/Bitbucket/MarlinV2_morphle/Marlin/src/lcd/extui/mks_ui/wifiSerial.h", "C++", 0, -17, 0, 0, 0, -21, -7, -45
"/home/sanjay/Desktop/Bitbucket/MarlinV2_morphle/Marlin/src/lcd/extui/mks_ui/wifiSerial_STM32.cpp", "C++", 0, -260, 0, 0, 0, -54, -44, -358
"/home/sanjay/Desktop/Bitbucket/MarlinV2_morphle/Marlin/src/lcd/extui/mks_ui/wifiSerial_STM32.h", "C++", 0, -33, 0, 0, 0, -24, -7, -64
"/home/sanjay/Desktop/Bitbucket/MarlinV2_morphle/Marlin/src/lcd/extui/mks_ui/wifiSerial_STM32F1.cpp", "C++", 0, -79, 0, 0, 0, -36, -28, -143
"/home/sanjay/Desktop/Bitbucket/MarlinV2_morphle/Marlin/src/lcd/extui/mks_ui/wifiSerial_STM32F1.h", "C++", 0, -40, 0, 0, 0, -32, -6, -78
"/home/sanjay/Desktop/Bitbucket/MarlinV2_morphle/Marlin/src/lcd/extui/mks_ui/wifi_module.cpp", "C++", 0, -1637, 0, 0, 0, -67, -359, -2063
"/home/sanjay/Desktop/Bitbucket/MarlinV2_morphle/Marlin/src/lcd/extui/mks_ui/wifi_module.h", "C++", 0, -149, 0, 0, 0, -22, -31, -202
"/home/sanjay/Desktop/Bitbucket/MarlinV2_morphle/Marlin/src/lcd/extui/mks_ui/wifi_upload.cpp", "C++", 0, -467, 0, 0, 0, -106, -112, -685
"/home/sanjay/Desktop/Bitbucket/MarlinV2_morphle/Marlin/src/lcd/extui/mks_ui/wifi_upload.h", "C++", 0, -45, 0, 0, 0, -21, -9, -75
"/home/sanjay/Desktop/Bitbucket/MarlinV2_morphle/Marlin/src/lcd/extui/nextion/FileNavigator.cpp", "C++", 0, -122, 0, 0, 0, -31, -22, -175
"/home/sanjay/Desktop/Bitbucket/MarlinV2_morphle/Marlin/src/lcd/extui/nextion/FileNavigator.h", "C++", 0, -21, 0, 0, 0, -27, -6, -54
"/home/sanjay/Desktop/Bitbucket/MarlinV2_morphle/Marlin/src/lcd/extui/nextion/nextion_extui.cpp", "C++", 0, -53, 0, 0, 0, -47, -24, -124
"/home/sanjay/Desktop/Bitbucket/MarlinV2_morphle/Marlin/src/lcd/extui/nextion/nextion_tft.cpp", "C++", 0, -610, 0, 0, 0, -51, -76, -737
"/home/sanjay/Desktop/Bitbucket/MarlinV2_morphle/Marlin/src/lcd/extui/nextion/nextion_tft.h", "C++", 0, -29, 0, 0, 0, -28, -7, -64
"/home/sanjay/Desktop/Bitbucket/MarlinV2_morphle/Marlin/src/lcd/extui/nextion/nextion_tft_defs.h", "C++", 0, -27, 0, 0, 0, -30, -7, -64
"/home/sanjay/Desktop/Bitbucket/MarlinV2_morphle/Marlin/src/lcd/extui/ui_api.cpp", "C++", 0, -909, 0, 0, 0, -102, -166, -1177
"/home/sanjay/Desktop/Bitbucket/MarlinV2_morphle/Marlin/src/lcd/extui/ui_api.h", "C++", 0, -314, 0, 0, 0, -78, -61, -453
"/home/sanjay/Desktop/Bitbucket/MarlinV2_morphle/Marlin/src/lcd/fontutils.cpp", "C++", 0, -137, 0, 0, 0, -47, -22, -206
"/home/sanjay/Desktop/Bitbucket/MarlinV2_morphle/Marlin/src/lcd/fontutils.h", "C++", 0, -31, 0, 0, 0, -35, -14, -80
"/home/sanjay/Desktop/Bitbucket/MarlinV2_morphle/Marlin/src/lcd/language/language_an.h", "C++", 0, -189, 0, 0, 0, -33, -14, -236
"/home/sanjay/Desktop/Bitbucket/MarlinV2_morphle/Marlin/src/lcd/language/language_bg.h", "C++", 0, -125, 0, 0, 0, -27, -7, -159
"/home/sanjay/Desktop/Bitbucket/MarlinV2_morphle/Marlin/src/lcd/language/language_ca.h", "C++", 0, -184, 0, 0, 0, -31, -15, -230
"/home/sanjay/Desktop/Bitbucket/MarlinV2_morphle/Marlin/src/lcd/language/language_cz.h", "C++", 0, -535, 0, 0, 0, -34, -20, -589
"/home/sanjay/Desktop/Bitbucket/MarlinV2_morphle/Marlin/src/lcd/language/language_da.h", "C++", 0, -157, 0, 0, 0, -27, -16, -200
"/home/sanjay/Desktop/Bitbucket/MarlinV2_morphle/Marlin/src/lcd/language/language_de.h", "C++", 0, -756, 0, 0, 0, -30, -29, -815
"/home/sanjay/Desktop/Bitbucket/MarlinV2_morphle/Marlin/src/lcd/language/language_el.h", "C++", 0, -175, 0, 0, 0, -27, -9, -211
"/home/sanjay/Desktop/Bitbucket/MarlinV2_morphle/Marlin/src/lcd/language/language_el_CY.h", "C++", 0, -7, 0, 0, 0, -27, -5, -39
"/home/sanjay/Desktop/Bitbucket/MarlinV2_morphle/Marlin/src/lcd/language/language_el_gr.h", "C++", 0, -164, 0, 0, 0, -27, -8, -199
"/home/sanjay/Desktop/Bitbucket/MarlinV2_morphle/Marlin/src/lcd/language/language_en.h", "C++", 0, -779, 0, 0, 0, -41, -29, -849
"/home/sanjay/Desktop/Bitbucket/MarlinV2_morphle/Marlin/src/lcd/language/language_es.h", "C++", 0, -537, 0, 0, 0, -27, -16, -580
"/home/sanjay/Desktop/Bitbucket/MarlinV2_morphle/Marlin/src/lcd/language/language_eu.h", "C++", 0, -277, 0, 0, 0, -31, -11, -319
"/home/sanjay/Desktop/Bitbucket/MarlinV2_morphle/Marlin/src/lcd/language/language_fi.h", "C++", 0, -97, 0, 0, 0, -27, -8, -132
"/home/sanjay/Desktop/Bitbucket/MarlinV2_morphle/Marlin/src/lcd/language/language_fr.h", "C++", 0, -576, 0, 0, 0, -29, -28, -633
"/home/sanjay/Desktop/Bitbucket/MarlinV2_morphle/Marlin/src/lcd/language/language_gl.h", "C++", 0, -551, 0, 0, 0, -27, -18, -596
"/home/sanjay/Desktop/Bitbucket/MarlinV2_morphle/Marlin/src/lcd/language/language_hr.h", "C++", 0, -132, 0, 0, 0, -29, -13, -174
"/home/sanjay/Desktop/Bitbucket/MarlinV2_morphle/Marlin/src/lcd/language/language_hu.h", "C++", 0, -646, 0, 0, 0, -36, -25, -707
"/home/sanjay/Desktop/Bitbucket/MarlinV2_morphle/Marlin/src/lcd/language/language_it.h", "C++", 0, -753, 0, 0, 0, -39, -30, -822
"/home/sanjay/Desktop/Bitbucket/MarlinV2_morphle/Marlin/src/lcd/language/language_jp_kana.h", "C++", 0, -205, 0, 0, 0, -32, -13, -250
"/home/sanjay/Desktop/Bitbucket/MarlinV2_morphle/Marlin/src/lcd/language/language_ko_KR.h", "C++", 0, -75, 0, 0, 0, -27, -5, -107
"/home/sanjay/Desktop/Bitbucket/MarlinV2_morphle/Marlin/src/lcd/language/language_nl.h", "C++", 0, -183, 0, 0, 0, -33, -15, -231
"/home/sanjay/Desktop/Bitbucket/MarlinV2_morphle/Marlin/src/lcd/language/language_pl.h", "C++", 0, -485, 0, 0, 0, -39, -26, -550
"/home/sanjay/Desktop/Bitbucket/MarlinV2_morphle/Marlin/src/lcd/language/language_pt.h", "C++", 0, -135, 0, 0, 0, -28, -10, -173
"/home/sanjay/Desktop/Bitbucket/MarlinV2_morphle/Marlin/src/lcd/language/language_pt_br.h", "C++", 0, -444, 0, 0, 0, -28, -15, -487
"/home/sanjay/Desktop/Bitbucket/MarlinV2_morphle/Marlin/src/lcd/language/language_ro.h", "C++", 0, -568, 0, 0, 0, -33, -17, -618
"/home/sanjay/Desktop/Bitbucket/MarlinV2_morphle/Marlin/src/lcd/language/language_ru.h", "C++", 0, -816, 0, 0, 0, -31, -37, -884
"/home/sanjay/Desktop/Bitbucket/MarlinV2_morphle/Marlin/src/lcd/language/language_sk.h", "C++", 0, -752, 0, 0, 0, -43, -26, -821
"/home/sanjay/Desktop/Bitbucket/MarlinV2_morphle/Marlin/src/lcd/language/language_sv.h", "C++", 0, -620, 0, 0, 0, -31, -24, -675
"/home/sanjay/Desktop/Bitbucket/MarlinV2_morphle/Marlin/src/lcd/language/language_test.h", "C++", 0, -149, 0, 0, 0, -52, -36, -237
"/home/sanjay/Desktop/Bitbucket/MarlinV2_morphle/Marlin/src/lcd/language/language_tr.h", "C++", 0, -527, 0, 0, 0, -35, -18, -580
"/home/sanjay/Desktop/Bitbucket/MarlinV2_morphle/Marlin/src/lcd/language/language_uk.h", "C++", 0, -850, 0, 0, 0, -33, -43, -926
"/home/sanjay/Desktop/Bitbucket/MarlinV2_morphle/Marlin/src/lcd/language/language_vi.h", "C++", 0, -402, 0, 0, 0, -31, -9, -442
"/home/sanjay/Desktop/Bitbucket/MarlinV2_morphle/Marlin/src/lcd/language/language_zh_CN.h", "C++", 0, -572, 0, 0, 0, -31, -18, -621
"/home/sanjay/Desktop/Bitbucket/MarlinV2_morphle/Marlin/src/lcd/language/language_zh_TW.h", "C++", 0, -455, 0, 0, 0, -31, -16, -502
"/home/sanjay/Desktop/Bitbucket/MarlinV2_morphle/Marlin/src/lcd/lcdprint.cpp", "C++", 0, -64, 0, 0, 0, -36, -10, -110
"/home/sanjay/Desktop/Bitbucket/MarlinV2_morphle/Marlin/src/lcd/lcdprint.h", "C++", 0, -122, 0, 0, 0, -140, -35, -297
"/home/sanjay/Desktop/Bitbucket/MarlinV2_morphle/Marlin/src/lcd/marlinui.cpp", "C++", 0, -1327, 0, 0, 0, -197, -356, -1880
"/home/sanjay/Desktop/Bitbucket/MarlinV2_morphle/Marlin/src/lcd/marlinui.h", "C++", 0, -607, 0, 0, 0, -47, -138, -792
"/home/sanjay/Desktop/Bitbucket/MarlinV2_morphle/Marlin/src/lcd/menu/game/brickout.cpp", "C++", 0, -135, 0, 0, 0, -43, -30, -208
"/home/sanjay/Desktop/Bitbucket/MarlinV2_morphle/Marlin/src/lcd/menu/game/brickout.h", "C++", 0, -12, 0, 0, 0, -21, -6, -39
"/home/sanjay/Desktop/Bitbucket/MarlinV2_morphle/Marlin/src/lcd/menu/game/game.cpp", "C++", 0, -35, 0, 0, 0, -21, -11, -67
"/home/sanjay/Desktop/Bitbucket/MarlinV2_morphle/Marlin/src/lcd/menu/game/game.h", "C++", 0, -40, 0, 0, 0, -23, -8, -71
"/home/sanjay/Desktop/Bitbucket/MarlinV2_morphle/Marlin/src/lcd/menu/game/invaders.cpp", "C++", 0, -321, 0, 0, 0, -59, -59, -439
"/home/sanjay/Desktop/Bitbucket/MarlinV2_morphle/Marlin/src/lcd/menu/game/invaders.h", "C++", 0, -32, 0, 0, 0, -21, -10, -63
"/home/sanjay/Desktop/Bitbucket/MarlinV2_morphle/Marlin/src/lcd/menu/game/maze.cpp", "C++", 0, -45, 0, 0, 0, -66, -24, -135
"/home/sanjay/Desktop/Bitbucket/MarlinV2_morphle/Marlin/src/lcd/menu/game/maze.h", "C++", 0, -5, 0, 0, 0, -21, -5, -31
"/home/sanjay/Desktop/Bitbucket/MarlinV2_morphle/Marlin/src/lcd/menu/game/snake.cpp", "C++", 0, -218, 0, 0, 0, -59, -47, -324
"/home/sanjay/Desktop/Bitbucket/MarlinV2_morphle/Marlin/src/lcd/menu/game/snake.h", "C++", 0, -13, 0, 0, 0, -21, -5, -39
"/home/sanjay/Desktop/Bitbucket/MarlinV2_morphle/Marlin/src/lcd/menu/game/types.h", "C++", 0, -19, 0, 0, 0, -22, -6, -47
"/home/sanjay/Desktop/Bitbucket/MarlinV2_morphle/Marlin/src/lcd/menu/menu.cpp", "C++", 0, -258, 0, 0, 0, -67, -53, -378
"/home/sanjay/Desktop/Bitbucket/MarlinV2_morphle/Marlin/src/lcd/menu/menu.h", "C++", 0, -171, 0, 0, 0, -60, -42, -273
"/home/sanjay/Desktop/Bitbucket/MarlinV2_morphle/Marlin/src/lcd/menu/menu_addon.h", "C++", 0, -8, 0, 0, 0, -21, -5, -34
"/home/sanjay/Desktop/Bitbucket/MarlinV2_morphle/Marlin/src/lcd/menu/menu_advanced.cpp", "C++", 0, -511, 0, 0, 0, -69, -125, -705
"/home/sanjay/Desktop/Bitbucket/MarlinV2_morphle/Marlin/src/lcd/menu/menu_backlash.cpp", "C++", 0, -41, 0, 0, 0, -24, -14, -79
"/home/sanjay/Desktop/Bitbucket/MarlinV2_morphle/Marlin/src/lcd/menu/menu_bed_corners.cpp", "C++", 0, -270, 0, 0, 0, -44, -52, -366
"/home/sanjay/Desktop/Bitbucket/MarlinV2_morphle/Marlin/src/lcd/menu/menu_bed_leveling.cpp", "C++", 0, -163, 0, 0, 0, -98, -44, -305
"/home/sanjay/Desktop/Bitbucket/MarlinV2_morphle/Marlin/src/lcd/menu/menu_cancelobject.cpp", "C++", 0, -38, 0, 0, 0, -25, -12, -75
"/home/sanjay/Desktop/Bitbucket/MarlinV2_morphle/Marlin/src/lcd/menu/menu_configuration.cpp", "C++", 0, -457, 0, 0, 0, -39, -97, -593
"/home/sanjay/Desktop/Bitbucket/MarlinV2_morphle/Marlin/src/lcd/menu/menu_delta_calibrate.cpp", "C++", 0, -110, 0, 0, 0, -24, -27, -161
"/home/sanjay/Desktop/Bitbucket/MarlinV2_morphle/Marlin/src/lcd/menu/menu_filament.cpp", "C++", 0, -268, 0, 0, 0, -44, -39, -351
"/home/sanjay/Desktop/Bitbucket/MarlinV2_morphle/Marlin/src/lcd/menu/menu_game.cpp", "C++", 0, -22, 0, 0, 0, -21, -6, -49
"/home/sanjay/Desktop/Bitbucket/MarlinV2_morphle/Marlin/src/lcd/menu/menu_info.cpp", "C++", 0, -231, 0, 0, 0, -40, -50, -321
"/home/sanjay/Desktop/Bitbucket/MarlinV2_morphle/Marlin/src/lcd/menu/menu_item.h", "C++", 0, -368, 0, 0, 0, -136, -71, -575
"/home/sanjay/Desktop/Bitbucket/MarlinV2_morphle/Marlin/src/lcd/menu/menu_job_recovery.cpp", "C++", 0, -23, 0, 0, 0, -26, -9, -58
"/home/sanjay/Desktop/Bitbucket/MarlinV2_morphle/Marlin/src/lcd/menu/menu_language.cpp", "C++", 0, -26, 0, 0, 0, -24, -10, -60
"/home/sanjay/Desktop/Bitbucket/MarlinV2_morphle/Marlin/src/lcd/menu/menu_led.cpp", "C++", 0, -122, 0, 0, 0, -27, -24, -173
"/home/sanjay/Desktop/Bitbucket/MarlinV2_morphle/Marlin/src/lcd/menu/menu_main.cpp", "C++", 0, -373, 0, 0, 0, -29, -63, -465
"/home/sanjay/Desktop/Bitbucket/MarlinV2_morphle/Marlin/src/lcd/menu/menu_media.cpp", "C++", 0, -120, 0, 0, 0, -25, -20, -165
"/home/sanjay/Desktop/Bitbucket/MarlinV2_morphle/Marlin/src/lcd/menu/menu_mixer.cpp", "C++", 0, -185, 0, 0, 0, -38, -56, -279
"/home/sanjay/Desktop/Bitbucket/MarlinV2_morphle/Marlin/src/lcd/menu/menu_mmu2.cpp", "C++", 0, -110, 0, 0, 0, -36, -25, -171
"/home/sanjay/Desktop/Bitbucket/MarlinV2_morphle/Marlin/src/lcd/menu/menu_mmu2.h", "C++", 0, -5, 0, 0, 0, -21, -3, -29
"/home/sanjay/Desktop/Bitbucket/MarlinV2_morphle/Marlin/src/lcd/menu/menu_motion.cpp", "C++", 0, -270, 0, 0, 0, -65, -75, -410
"/home/sanjay/Desktop/Bitbucket/MarlinV2_morphle/Marlin/src/lcd/menu/menu_password.cpp", "C++", 0, -115, 0, 0, 0, -41, -32, -188
"/home/sanjay/Desktop/Bitbucket/MarlinV2_morphle/Marlin/src/lcd/menu/menu_power_monitor.cpp", "C++", 0, -28, 0, 0, 0, -24, -11, -63
"/home/sanjay/Desktop/Bitbucket/MarlinV2_morphle/Marlin/src/lcd/menu/menu_probe_offset.cpp", "C++", 0, -96, 0, 0, 0, -35, -34, -165
"/home/sanjay/Desktop/Bitbucket/MarlinV2_morphle/Marlin/src/lcd/menu/menu_spindle_laser.cpp", "C++", 0, -47, 0, 0, 0, -27, -15, -89
"/home/sanjay/Desktop/Bitbucket/MarlinV2_morphle/Marlin/src/lcd/menu/menu_temperature.cpp", "C++", 0, -201, 0, 0, 0, -56, -54, -311
"/home/sanjay/Desktop/Bitbucket/MarlinV2_morphle/Marlin/src/lcd/menu/menu_tmc.cpp", "C++", 0, -137, 0, 0, 0, -24, -21, -182
"/home/sanjay/Desktop/Bitbucket/MarlinV2_morphle/Marlin/src/lcd/menu/menu_touch_screen.cpp", "C++", 0, -8, 0, 0, 0, -21, -8, -37
"/home/sanjay/Desktop/Bitbucket/MarlinV2_morphle/Marlin/src/lcd/menu/menu_tramming.cpp", "C++", 0, -63, 0, 0, 0, -30, -23, -116
"/home/sanjay/Desktop/Bitbucket/MarlinV2_morphle/Marlin/src/lcd/menu/menu_tune.cpp", "C++", 0, -159, 0, 0, 0, -53, -30, -242
"/home/sanjay/Desktop/Bitbucket/MarlinV2_morphle/Marlin/src/lcd/menu/menu_ubl.cpp", "C++", 0, -410, 0, 0, 0, -197, -68, -675
"/home/sanjay/Desktop/Bitbucket/MarlinV2_morphle/Marlin/src/lcd/menu/menu_x_twist.cpp", "C++", 0, -121, 0, 0, 0, -59, -34, -214
"/home/sanjay/Desktop/Bitbucket/MarlinV2_morphle/Marlin/src/lcd/scaled_tft.h", "C++", 0, -29, 0, 0, 0, -21, -6, -56
"/home/sanjay/Desktop/Bitbucket/MarlinV2_morphle/Marlin/src/lcd/tft/canvas.cpp", "C++", 0, -123, 0, 0, 0, -29, -28, -180
"/home/sanjay/Desktop/Bitbucket/MarlinV2_morphle/Marlin/src/lcd/tft/canvas.h", "C++", 0, -27, 0, 0, 0, -21, -10, -58
"/home/sanjay/Desktop/Bitbucket/MarlinV2_morphle/Marlin/src/lcd/tft/fontdata/fontdata_10x20.cpp", "C++", 0, -222, 0, 0, 0, -32, -7, -261
"/home/sanjay/Desktop/Bitbucket/MarlinV2_morphle/Marlin/src/lcd/tft/fontdata/fontdata_ISO10646_1.cpp", "C++", 0, -261, 0, 0, 0, -45, -12, -318
"/home/sanjay/Desktop/Bitbucket/MarlinV2_morphle/Marlin/src/lcd/tft/fontdata/helvetica_12_bold.cpp", "C++", 0, -267, 0, 0, 0, -32, -7, -306
"/home/sanjay/Desktop/Bitbucket/MarlinV2_morphle/Marlin/src/lcd/tft/fontdata/helvetica_14.cpp", "C++", 0, -331, 0, 0, 0, -42, -9, -382
"/home/sanjay/Desktop/Bitbucket/MarlinV2_morphle/Marlin/src/lcd/tft/fontdata/helvetica_18.cpp", "C++", 0, -475, 0, 0, 0, -11, -7, -493
"/home/sanjay/Desktop/Bitbucket/MarlinV2_morphle/Marlin/src/lcd/tft/fontdata/profont_22.cpp", "C++", 0, -410, 0, 0, 0, -11, -6, -427
"/home/sanjay/Desktop/Bitbucket/MarlinV2_morphle/Marlin/src/lcd/tft/images/back_32x32x4.cpp", "C++", 0, -37, 0, 0, 0, -21, -5, -63
"/home/sanjay/Desktop/Bitbucket/MarlinV2_morphle/Marlin/src/lcd/tft/images/background_320x30x16.cpp", "C++", 0, -35, 0, 0, 0, -21, -5, -61
"/home/sanjay/Desktop/Bitbucket/MarlinV2_morphle/Marlin/src/lcd/tft/images/bootscreen_112x38x1.cpp", "C++", 0, -44, 0, 0, 0, -21, -6, -71
"/home/sanjay/Desktop/Bitbucket/MarlinV2_morphle/Marlin/src/lcd/tft/images/bootscreen_195x59x16.cpp", "C++", 0, -64, 0, 0, 0, -21, -5, -90
"/home/sanjay/Desktop/Bitbucket/MarlinV2_morphle/Marlin/src/lcd/tft/images/bootscreen_228x255x2.cpp", "C++", 0, -260, 0, 0, 0, -21, -5, -286
"/home/sanjay/Desktop/Bitbucket/MarlinV2_morphle/Marlin/src/lcd/tft/images/bootscreen_228x255x4.cpp", "C++", 0, -260, 0, 0, 0, -21, -5, -286
"/home/sanjay/Desktop/Bitbucket/MarlinV2_morphle/Marlin/src/lcd/tft/images/bootscreen_320x240x16.cpp", "C++", 0, -245, 0, 0, 0, -21, -5, -271
"/home/sanjay/Desktop/Bitbucket/MarlinV2_morphle/Marlin/src/lcd/tft/images/bootscreen_480x320x16.cpp", "C++", 0, -325, 0, 0, 0, -21, -5, -351
"/home/sanjay/Desktop/Bitbucket/MarlinV2_morphle/Marlin/src/lcd/tft/images/btn_rounded_42x39x4.cpp", "C++", 0, -44, 0, 0, 0, -21, -5, -70
"/home/sanjay/Desktop/Bitbucket/MarlinV2_morphle/Marlin/src/lcd/tft/images/btn_rounded_64x52x4.cpp", "C++", 0, -57, 0, 0, 0, -21, -5, -83
"/home/sanjay/Desktop/Bitbucket/MarlinV2_morphle/Marlin/src/lcd/tft/images/cancel_64x64x4.cpp", "C++", 0, -69, 0, 0, 0, -21, -5, -95
"/home/sanjay/Desktop/Bitbucket/MarlinV2_morphle/Marlin/src/lcd/tft/images/chamber_64x64x4.cpp", "C++", 0, -135, 0, 0, 0, -21, -6, -162
"/home/sanjay/Desktop/Bitbucket/MarlinV2_morphle/Marlin/src/lcd/tft/images/confirm_64x64x4.cpp", "C++", 0, -69, 0, 0, 0, -21, -5, -95
"/home/sanjay/Desktop/Bitbucket/MarlinV2_morphle/Marlin/src/lcd/tft/images/decrease_64x64x4.cpp", "C++", 0, -69, 0, 0, 0, -21, -5, -95
"/home/sanjay/Desktop/Bitbucket/MarlinV2_morphle/Marlin/src/lcd/tft/images/directory_32x32x4.cpp", "C++", 0, -37, 0, 0, 0, -21, -5, -63
"/home/sanjay/Desktop/Bitbucket/MarlinV2_morphle/Marlin/src/lcd/tft/images/down_32x32x4.cpp", "C++", 0, -37, 0, 0, 0, -21, -5, -63
"/home/sanjay/Desktop/Bitbucket/MarlinV2_morphle/Marlin/src/lcd/tft/images/fan_64x64x4.cpp", "C++", 0, -135, 0, 0, 0, -21, -6, -162
"/home/sanjay/Desktop/Bitbucket/MarlinV2_morphle/Marlin/src/lcd/tft/images/fan_fast_64x64x4.cpp", "C++", 0, -135, 0, 0, 0, -21, -6, -162
"/home/sanjay/Desktop/Bitbucket/MarlinV2_morphle/Marlin/src/lcd/tft/images/fan_slow_64x64x4.cpp", "C++", 0, -135, 0, 0, 0, -21, -6, -162
"/home/sanjay/Desktop/Bitbucket/MarlinV2_morphle/Marlin/src/lcd/tft/images/feedrate_32x32x4.cpp", "C++", 0, -37, 0, 0, 0, -21, -5, -63
"/home/sanjay/Desktop/Bitbucket/MarlinV2_morphle/Marlin/src/lcd/tft/images/flowrate_32x32x4.cpp", "C++", 0, -37, 0, 0, 0, -21, -5, -63
"/home/sanjay/Desktop/Bitbucket/MarlinV2_morphle/Marlin/src/lcd/tft/images/heated_bed_64x64x4.cpp", "C++", 0, -135, 0, 0, 0, -21, -6, -162
"/home/sanjay/Desktop/Bitbucket/MarlinV2_morphle/Marlin/src/lcd/tft/images/home_64x64x4.cpp", "C++", 0, -69, 0, 0, 0, -21, -5, -95
"/home/sanjay/Desktop/Bitbucket/MarlinV2_morphle/Marlin/src/lcd/tft/images/hotend_64x64x4.cpp", "C++", 0, -69, 0, 0, 0, -21, -5, -95
"/home/sanjay/Desktop/Bitbucket/MarlinV2_morphle/Marlin/src/lcd/tft/images/increase_64x64x4.cpp", "C++", 0, -69, 0, 0, 0, -21, -5, -95
"/home/sanjay/Desktop/Bitbucket/MarlinV2_morphle/Marlin/src/lcd/tft/images/left_32x32x4.cpp", "C++", 0, -37, 0, 0, 0, -21, -5, -63
"/home/sanjay/Desktop/Bitbucket/MarlinV2_morphle/Marlin/src/lcd/tft/images/leveling_32x32x4.cpp", "C++", 0, -37, 0, 0, 0, -21, -5, -63
"/home/sanjay/Desktop/Bitbucket/MarlinV2_morphle/Marlin/src/lcd/tft/images/menu_64x64x4.cpp", "C++", 0, -69, 0, 0, 0, -21, -5, -95
"/home/sanjay/Desktop/Bitbucket/MarlinV2_morphle/Marlin/src/lcd/tft/images/pause_64x64x4.cpp", "C++", 0, -69, 0, 0, 0, -21, -5, -95
"/home/sanjay/Desktop/Bitbucket/MarlinV2_morphle/Marlin/src/lcd/tft/images/refresh_32x32x4.cpp", "C++", 0, -37, 0, 0, 0, -21, -5, -63
"/home/sanjay/Desktop/Bitbucket/MarlinV2_morphle/Marlin/src/lcd/tft/images/right_32x32x4.cpp", "C++", 0, -37, 0, 0, 0, -21, -5, -63
"/home/sanjay/Desktop/Bitbucket/MarlinV2_morphle/Marlin/src/lcd/tft/images/sd_64x64x4.cpp", "C++", 0, -69, 0, 0, 0, -21, -5, -95
"/home/sanjay/Desktop/Bitbucket/MarlinV2_morphle/Marlin/src/lcd/tft/images/settings_64x64x4.cpp", "C++", 0, -69, 0, 0, 0, -21, -5, -95
"/home/sanjay/Desktop/Bitbucket/MarlinV2_morphle/Marlin/src/lcd/tft/images/slider_8x16x4.cpp", "C++", 0, -21, 0, 0, 0, -21, -5, -47
"/home/sanjay/Desktop/Bitbucket/MarlinV2_morphle/Marlin/src/lcd/tft/images/up_32x32x4.cpp", "C++", 0, -37, 0, 0, 0, -21, -5, -63
"/home/sanjay/Desktop/Bitbucket/MarlinV2_morphle/Marlin/src/lcd/tft/tft.cpp", "C++", 0, -12, 0, 0, 0, -22, -9, -43
"/home/sanjay/Desktop/Bitbucket/MarlinV2_morphle/Marlin/src/lcd/tft/tft.h", "C++", 0, -69, 0, 0, 0, -23, -14, -106
"/home/sanjay/Desktop/Bitbucket/MarlinV2_morphle/Marlin/src/lcd/tft/tft_color.h", "C++", 0, -135, 0, 0, 0, -23, -23, -181
"/home/sanjay/Desktop/Bitbucket/MarlinV2_morphle/Marlin/src/lcd/tft/tft_image.cpp", "C++", 0, -82, 0, 0, 0, -21, -11, -114
"/home/sanjay/Desktop/Bitbucket/MarlinV2_morphle/Marlin/src/lcd/tft/tft_image.h", "C++", 0, -140, 0, 0, 0, -21, -18, -179
"/home/sanjay/Desktop/Bitbucket/MarlinV2_morphle/Marlin/src/lcd/tft/tft_queue.cpp", "C++", 0, -260, 0, 0, 0, -23, -72, -355
"/home/sanjay/Desktop/Bitbucket/MarlinV2_morphle/Marlin/src/lcd/tft/tft_queue.h", "C++", 0, -112, 0, 0, 0, -21, -20, -153
"/home/sanjay/Desktop/Bitbucket/MarlinV2_morphle/Marlin/src/lcd/tft/tft_string.cpp", "C++", 0, -122, 0, 0, 0, -31, -24, -177
"/home/sanjay/Desktop/Bitbucket/MarlinV2_morphle/Marlin/src/lcd/tft/tft_string.h", "C++", 0, -71, 0, 0, 0, -60, -26, -157
"/home/sanjay/Desktop/Bitbucket/MarlinV2_morphle/Marlin/src/lcd/tft/touch.cpp", "C++", 0, -264, 0, 0, 0, -24, -38, -326
"/home/sanjay/Desktop/Bitbucket/MarlinV2_morphle/Marlin/src/lcd/tft/touch.h", "C++", 0, -97, 0, 0, 0, -22, -18, -137
"/home/sanjay/Desktop/Bitbucket/MarlinV2_morphle/Marlin/src/lcd/tft/ui_1024x600.cpp", "C++", 0, -740, 0, 0, 0, -48, -150, -938
"/home/sanjay/Desktop/Bitbucket/MarlinV2_morphle/Marlin/src/lcd/tft/ui_1024x600.h", "C++", 0, -15, 0, 0, 0, -21, -8, -44
"/home/sanjay/Desktop/Bitbucket/MarlinV2_morphle/Marlin/src/lcd/tft/ui_320x240.cpp", "C++", 0, -723, 0, 0, 0, -48, -147, -918
"/home/sanjay/Desktop/Bitbucket/MarlinV2_morphle/Marlin/src/lcd/tft/ui_320x240.h", "C++", 0, -14, 0, 0, 0, -21, -8, -43
"/home/sanjay/Desktop/Bitbucket/MarlinV2_morphle/Marlin/src/lcd/tft/ui_480x320.cpp", "C++", 0, -722, 0, 0, 0, -48, -149, -919
"/home/sanjay/Desktop/Bitbucket/MarlinV2_morphle/Marlin/src/lcd/tft/ui_480x320.h", "C++", 0, -22, 0, 0, 0, -21, -7, -50
"/home/sanjay/Desktop/Bitbucket/MarlinV2_morphle/Marlin/src/lcd/tft/ui_common.cpp", "C++", 0, -191, 0, 0, 0, -34, -53, -278
"/home/sanjay/Desktop/Bitbucket/MarlinV2_morphle/Marlin/src/lcd/tft/ui_common.h", "C++", 0, -57, 0, 0, 0, -21, -11, -89
"/home/sanjay/Desktop/Bitbucket/MarlinV2_morphle/Marlin/src/lcd/tft_io/ili9328.h", "C++", 0, -121, 0, 0, 0, -29, -24, -174
"/home/sanjay/Desktop/Bitbucket/MarlinV2_morphle/Marlin/src/lcd/tft_io/ili9341.h", "C++", 0, -121, 0, 0, 0, -36, -14, -171
"/home/sanjay/Desktop/Bitbucket/MarlinV2_morphle/Marlin/src/lcd/tft_io/ili9488.h", "C++", 0, -129, 0, 0, 0, -22, -14, -165
"/home/sanjay/Desktop/Bitbucket/MarlinV2_morphle/Marlin/src/lcd/tft_io/r65105.h", "C++", 0, -119, 0, 0, 0, -29, -29, -177
"/home/sanjay/Desktop/Bitbucket/MarlinV2_morphle/Marlin/src/lcd/tft_io/ssd1963.h", "C++", 0, -98, 0, 0, 0, -21, -13, -132
"/home/sanjay/Desktop/Bitbucket/MarlinV2_morphle/Marlin/src/lcd/tft_io/st7735.h", "C++", 0, -89, 0, 0, 0, -35, -13, -137
"/home/sanjay/Desktop/Bitbucket/MarlinV2_morphle/Marlin/src/lcd/tft_io/st7789v.h", "C++", 0, -122, 0, 0, 0, -21, -14, -157
"/home/sanjay/Desktop/Bitbucket/MarlinV2_morphle/Marlin/src/lcd/tft_io/st7796s.h", "C++", 0, -120, 0, 0, 0, -22, -16, -158
"/home/sanjay/Desktop/Bitbucket/MarlinV2_morphle/Marlin/src/lcd/tft_io/tft_ids.h", "C++", 0, -12, 0, 0, 0, -21, -2, -35
"/home/sanjay/Desktop/Bitbucket/MarlinV2_morphle/Marlin/src/lcd/tft_io/tft_io.cpp", "C++", 0, -200, 0, 0, 0, -26, -33, -259
"/home/sanjay/Desktop/Bitbucket/MarlinV2_morphle/Marlin/src/lcd/tft_io/tft_io.h", "C++", 0, -79, 0, 0, 0, -30, -26, -135
"/home/sanjay/Desktop/Bitbucket/MarlinV2_morphle/Marlin/src/lcd/tft_io/touch_calibration.cpp", "C++", 0, -78, 0, 0, 0, -21, -17, -116
"/home/sanjay/Desktop/Bitbucket/MarlinV2_morphle/Marlin/src/lcd/tft_io/touch_calibration.h", "C++", 0, -62, 0, 0, 0, -21, -13, -96
"/home/sanjay/Desktop/Bitbucket/MarlinV2_morphle/Marlin/src/lcd/thermistornames.h", "C++", 0, -110, 0, 0, 0, -35, -10, -155
"/home/sanjay/Desktop/Bitbucket/MarlinV2_morphle/Marlin/src/lcd/touch/touch_buttons.cpp", "C++", 0, -97, 0, 0, 0, -24, -23, -144
"/home/sanjay/Desktop/Bitbucket/MarlinV2_morphle/Marlin/src/lcd/touch/touch_buttons.h", "C++", 0, -35, 0, 0, 0, -22, -15, -72
"/home/sanjay/Desktop/Bitbucket/MarlinV2_morphle/Marlin/src/libs/BL24CXX.cpp", "C++", 0, -182, 0, 0, 0, -73, -31, -286
"/home/sanjay/Desktop/Bitbucket/MarlinV2_morphle/Marlin/src/libs/BL24CXX.h", "C++", 0, -37, 0, 0, 0, -28, -8, -73
"/home/sanjay/Desktop/Bitbucket/MarlinV2_morphle/Marlin/src/libs/L64XX/L64XX_Marlin.cpp", "C++", 0, -831, 0, 0, 0, -61, -107, -999
"/home/sanjay/Desktop/Bitbucket/MarlinV2_morphle/Marlin/src/libs/L64XX/L64XX_Marlin.h", "C++", 0, -88, 0, 0, 0, -26, -28, -142
"/home/sanjay/Desktop/Bitbucket/MarlinV2_morphle/Marlin/src/libs/L64XX/README.md", "Markdown", 0, 0, 0, -52, 0, 0, -47, -99
"/home/sanjay/Desktop/Bitbucket/MarlinV2_morphle/Marlin/src/libs/MAX31865.cpp", "C++", 0, -339, 0, 0, 0, -197, -103, -639
"/home/sanjay/Desktop/Bitbucket/MarlinV2_morphle/Marlin/src/libs/MAX31865.h", "C++", 0, -95, 0, 0, 0, -42, -30, -167
"/home/sanjay/Desktop/Bitbucket/MarlinV2_morphle/Marlin/src/libs/W25Qxx.cpp", "C++", 0, -182, 0, 0, 0, -151, -51, -384
"/home/sanjay/Desktop/Bitbucket/MarlinV2_morphle/Marlin/src/libs/W25Qxx.h", "C++", 0, -45, 0, 0, 0, -21, -9, -75
"/home/sanjay/Desktop/Bitbucket/MarlinV2_morphle/Marlin/src/libs/autoreport.h", "C++", 0, -25, 0, 0, 0, -21, -5, -51
"/home/sanjay/Desktop/Bitbucket/MarlinV2_morphle/Marlin/src/libs/bresenham.h", "C++", 0, -76, 0, 0, 0, -33, -24, -133
"/home/sanjay/Desktop/Bitbucket/MarlinV2_morphle/Marlin/src/libs/buzzer.cpp", "C++", 0, -44, 0, 0, 0, -29, -12, -85
"/home/sanjay/Desktop/Bitbucket/MarlinV2_morphle/Marlin/src/libs/buzzer.h", "C++", 0, -46, 0, 0, 0, -64, -26, -136
"/home/sanjay/Desktop/Bitbucket/MarlinV2_morphle/Marlin/src/libs/circularqueue.h", "C++", 0, -39, 0, 0, 0, -75, -18, -132
"/home/sanjay/Desktop/Bitbucket/MarlinV2_morphle/Marlin/src/libs/crc16.cpp", "C++", 0, -9, 0, 0, 0, -21, -3, -33
"/home/sanjay/Desktop/Bitbucket/MarlinV2_morphle/Marlin/src/libs/crc16.h", "C++", 0, -3, 0, 0, 0, -21, -3, -27
"/home/sanjay/Desktop/Bitbucket/MarlinV2_morphle/Marlin/src/libs/duration_t.h", "C++", 0, -71, 0, 0, 0, -93, -17, -181
"/home/sanjay/Desktop/Bitbucket/MarlinV2_morphle/Marlin/src/libs/heatshrink/heatshrink_common.h", "C++", 0, -11, 0, 0, 0, -4, -6, -21
"/home/sanjay/Desktop/Bitbucket/MarlinV2_morphle/Marlin/src/libs/heatshrink/heatshrink_config.h", "C++", 0, -13, 0, 0, 0, -9, -5, -27
"/home/sanjay/Desktop/Bitbucket/MarlinV2_morphle/Marlin/src/libs/heatshrink/heatshrink_decoder.cpp", "C++", 0, -294, 0, 0, 0, -47, -44, -385
"/home/sanjay/Desktop/Bitbucket/MarlinV2_morphle/Marlin/src/libs/heatshrink/heatshrink_decoder.h", "C++", 0, -62, 0, 0, 0, -41, -17, -120
"/home/sanjay/Desktop/Bitbucket/MarlinV2_morphle/Marlin/src/libs/hex_print.cpp", "C++", 0, -57, 0, 0, 0, -21, -13, -91
"/home/sanjay/Desktop/Bitbucket/MarlinV2_morphle/Marlin/src/libs/hex_print.h", "C++", 0, -13, 0, 0, 0, -24, -5, -42
"/home/sanjay/Desktop/Bitbucket/MarlinV2_morphle/Marlin/src/libs/least_squares_fit.cpp", "C++", 0, -26, 0, 0, 0, -31, -13, -70
"/home/sanjay/Desktop/Bitbucket/MarlinV2_morphle/Marlin/src/libs/least_squares_fit.h", "C++", 0, -47, 0, 0, 0, -33, -8, -88
"/home/sanjay/Desktop/Bitbucket/MarlinV2_morphle/Marlin/src/libs/nozzle.cpp", "C++", 0, -175, 0, 0, 0, -57, -44, -276
"/home/sanjay/Desktop/Bitbucket/MarlinV2_morphle/Marlin/src/libs/nozzle.h", "C++", 0, -19, 0, 0, 0, -58, -16, -93
"/home/sanjay/Desktop/Bitbucket/MarlinV2_morphle/Marlin/src/libs/numtostr.cpp", "C++", 0, -327, 0, 0, 0, -52, -39, -418
"/home/sanjay/Desktop/Bitbucket/MarlinV2_morphle/Marlin/src/libs/numtostr.h", "C++", 0, -41, 0, 0, 0, -54, -34, -129
"/home/sanjay/Desktop/Bitbucket/MarlinV2_morphle/Marlin/src/libs/private_spi.h", "C++", 0, -29, 0, 0, 0, -22, -4, -55
"/home/sanjay/Desktop/Bitbucket/MarlinV2_morphle/Marlin/src/libs/softspi.h", "C++", 0, -493, 0, 0, 0, -173, -77, -743
"/home/sanjay/Desktop/Bitbucket/MarlinV2_morphle/Marlin/src/libs/stopwatch.cpp", "C++", 0, -61, 0, 0, 0, -21, -21, -103
"/home/sanjay/Desktop/Bitbucket/MarlinV2_morphle/Marlin/src/libs/stopwatch.h", "C++", 0, -26, 0, 0, 0, -76, -19, -121
"/home/sanjay/Desktop/Bitbucket/MarlinV2_morphle/Marlin/src/libs/vector_3.cpp", "C++", 0, -69, 0, 0, 0, -59, -24, -152
"/home/sanjay/Desktop/Bitbucket/MarlinV2_morphle/Marlin/src/libs/vector_3.h", "C++", 0, -37, 0, 0, 0, -44, -17, -98
"/home/sanjay/Desktop/Bitbucket/MarlinV2_morphle/Marlin/src/module/delta.cpp", "C++", 0, -142, 0, 0, 0, -108, -40, -290
"/home/sanjay/Desktop/Bitbucket/MarlinV2_morphle/Marlin/src/module/delta.h", "C++", 0, -36, 0, 0, 0, -79, -15, -130
"/home/sanjay/Desktop/Bitbucket/MarlinV2_morphle/Marlin/src/module/endstops.cpp", "C++", 0, -1203, 0, 0, 0, -83, -138, -1424
"/home/sanjay/Desktop/Bitbucket/MarlinV2_morphle/Marlin/src/module/endstops.h", "C++", 0, -161, 0, 0, 0, -67, -38, -266
"/home/sanjay/Desktop/Bitbucket/MarlinV2_morphle/Marlin/src/module/motion.cpp", "C++", 0, -1494, 0, 0, 0, -384, -332, -2210
"/home/sanjay/Desktop/Bitbucket/MarlinV2_morphle/Marlin/src/module/motion.h", "C++", 0, -416, 0, 0, 0, -83, -83, -582
"/home/sanjay/Desktop/Bitbucket/MarlinV2_morphle/Marlin/src/module/planner.cpp", "C++", 0, -1932, 0, 0, 0, -957, -465, -3354
"/home/sanjay/Desktop/Bitbucket/MarlinV2_morphle/Marlin/src/module/planner.h", "C++", 0, -608, 0, 0, 0, -266, -191, -1065
"/home/sanjay/Desktop/Bitbucket/MarlinV2_morphle/Marlin/src/module/planner_bezier.cpp", "C++", 0, -95, 0, 0, 0, -93, -24, -212
"/home/sanjay/Desktop/Bitbucket/MarlinV2_morphle/Marlin/src/module/planner_bezier.h", "C++", 0, -9, 0, 0, 0, -26, -4, -39
"/home/sanjay/Desktop/Bitbucket/MarlinV2_morphle/Marlin/src/module/polargraph.cpp", "C++", 0, -18, 0, 0, 0, -25, -12, -55
"/home/sanjay/Desktop/Bitbucket/MarlinV2_morphle/Marlin/src/module/polargraph.h", "C++", 0, -8, 0, 0, 0, -24, -5, -37
"/home/sanjay/Desktop/Bitbucket/MarlinV2_morphle/Marlin/src/module/printcounter.cpp", "C++", 0, -271, 0, 0, 0, -28, -61, -360
"/home/sanjay/Desktop/Bitbucket/MarlinV2_morphle/Marlin/src/module/printcounter.h", "C++", 0, -70, 0, 0, 0, -105, -30, -205
"/home/sanjay/Desktop/Bitbucket/MarlinV2_morphle/Marlin/src/module/probe.cpp", "C++", 0, -625, 0, 0, 0, -150, -167, -942
"/home/sanjay/Desktop/Bitbucket/MarlinV2_morphle/Marlin/src/module/probe.h", "C++", 0, -227, 0, 0, 0, -47, -45, -319
"/home/sanjay/Desktop/Bitbucket/MarlinV2_morphle/Marlin/src/module/scara.cpp", "C++", 0, -150, 0, 0, 0, -95, -65, -310
"/home/sanjay/Desktop/Bitbucket/MarlinV2_morphle/Marlin/src/module/scara.h", "C++", 0, -18, 0, 0, 0, -24, -12, -54
"/home/sanjay/Desktop/Bitbucket/MarlinV2_morphle/Marlin/src/module/servo.cpp", "C++", 0, -26, 0, 0, 0, -24, -9, -59
"/home/sanjay/Desktop/Bitbucket/MarlinV2_morphle/Marlin/src/module/servo.h", "C++", 0, -75, 0, 0, 0, -25, -14, -114
"/home/sanjay/Desktop/Bitbucket/MarlinV2_morphle/Marlin/src/module/settings.cpp", "C++", 0, -2319, 0, 0, 0, -800, -493, -3612
"/home/sanjay/Desktop/Bitbucket/MarlinV2_morphle/Marlin/src/module/settings.h", "C++", 0, -89, 0, 0, 0, -29, -32, -150
"/home/sanjay/Desktop/Bitbucket/MarlinV2_morphle/Marlin/src/module/stepper.cpp", "C++", 0, -2755, 0, 0, 0, -646, -424, -3825
"/home/sanjay/Desktop/Bitbucket/MarlinV2_morphle/Marlin/src/module/stepper.h", "C++", 0, -435, 0, 0, 0, -145, -115, -695
"/home/sanjay/Desktop/Bitbucket/MarlinV2_morphle/Marlin/src/module/stepper/L64xx.cpp", "C++", 0, -194, 0, 0, 0, -39, -14, -247
"/home/sanjay/Desktop/Bitbucket/MarlinV2_morphle/Marlin/src/module/stepper/L64xx.h", "C++", 0, -350, 0, 0, 0, -45, -30, -425
"/home/sanjay/Desktop/Bitbucket/MarlinV2_morphle/Marlin/src/module/stepper/TMC26X.cpp", "C++", 0, -125, 0, 0, 0, -28, -10, -163
"/home/sanjay/Desktop/Bitbucket/MarlinV2_morphle/Marlin/src/module/stepper/TMC26X.h", "C++", 0, -119, 0, 0, 0, -45, -25, -189
"/home/sanjay/Desktop/Bitbucket/MarlinV2_morphle/Marlin/src/module/stepper/indirection.cpp", "C++", 0, -13, 0, 0, 0, -30, -6, -49
"/home/sanjay/Desktop/Bitbucket/MarlinV2_morphle/Marlin/src/module/stepper/indirection.h", "C++", 0, -898, 0, 0, 0, -64, -98, -1060
"/home/sanjay/Desktop/Bitbucket/MarlinV2_morphle/Marlin/src/module/stepper/speed_lookuptable.h", "C++", 0, -140, 0, 0, 0, -21, -8, -169
"/home/sanjay/Desktop/Bitbucket/MarlinV2_morphle/Marlin/src/module/stepper/trinamic.cpp", "C++", 0, -859, 0, 0, 0, -51, -79, -989
"/home/sanjay/Desktop/Bitbucket/MarlinV2_morphle/Marlin/src/module/stepper/trinamic.h", "C++", 0, -335, 0, 0, 0, -44, -33, -412
"/home/sanjay/Desktop/Bitbucket/MarlinV2_morphle/Marlin/src/module/temperature.cpp", "C++", 0, -3399, 0, 0, 0, -404, -657, -4460
"/home/sanjay/Desktop/Bitbucket/MarlinV2_morphle/Marlin/src/module/temperature.h", "C++", 0, -867, 0, 0, 0, -88, -161, -1116
"/home/sanjay/Desktop/Bitbucket/MarlinV2_morphle/Marlin/src/module/thermistor/thermistor_1.h", "C++", 0, -67, 0, 0, 0, -22, -2, -91
"/home/sanjay/Desktop/Bitbucket/MarlinV2_morphle/Marlin/src/module/thermistor/thermistor_10.h", "C++", 0, -34, 0, 0, 0, -22, -2, -58
"/home/sanjay/Desktop/Bitbucket/MarlinV2_morphle/Marlin/src/module/thermistor/thermistor_1010.h", "C++", 0, -17, 0, 0, 0, -22, -3, -42
"/home/sanjay/Desktop/Bitbucket/MarlinV2_morphle/Marlin/src/module/thermistor/thermistor_1047.h", "C++", 0, -15, 0, 0, 0, -23, -3, -41
"/home/sanjay/Desktop/Bitbucket/MarlinV2_morphle/Marlin/src/module/thermistor/thermistor_11.h", "C++", 0, -53, 0, 0, 0, -22, -2, -77
"/home/sanjay/Desktop/Bitbucket/MarlinV2_morphle/Marlin/src/module/thermistor/thermistor_110.h", "C++", 0, -11, 0, 0, 0, -23, -3, -37
"/home/sanjay/Desktop/Bitbucket/MarlinV2_morphle/Marlin/src/module/thermistor/thermistor_12.h", "C++", 0, -33, 0, 0, 0, -22, -2, -57
"/home/sanjay/Desktop/Bitbucket/MarlinV2_morphle/Marlin/src/module/thermistor/thermistor_13.h", "C++", 0, -26, 0, 0, 0, -22, -2, -50
"/home/sanjay/Desktop/Bitbucket/MarlinV2_morphle/Marlin/src/module/thermistor/thermistor_147.h", "C++", 0, -11, 0, 0, 0, -23, -3, -37
"/home/sanjay/Desktop/Bitbucket/MarlinV2_morphle/Marlin/src/module/thermistor/thermistor_15.h", "C++", 0, -42, 0, 0, 0, -22, -2, -66
"/home/sanjay/Desktop/Bitbucket/MarlinV2_morphle/Marlin/src/module/thermistor/thermistor_17.h", "C++", 0, -55, 0, 0, 0, -22, -2, -79
"/home/sanjay/Desktop/Bitbucket/MarlinV2_morphle/Marlin/src/module/thermistor/thermistor_18.h", "C++", 0, -36, 0, 0, 0, -22, -2, -60
"/home/sanjay/Desktop/Bitbucket/MarlinV2_morphle/Marlin/src/module/thermistor/thermistor_2.h", "C++", 0, -35, 0, 0, 0, -26, -2, -63
"/home/sanjay/Desktop/Bitbucket/MarlinV2_morphle/Marlin/src/module/thermistor/thermistor_20.h", "C++", 0, -53, 0, 0, 0, -22, -3, -78
"/home/sanjay/Desktop/Bitbucket/MarlinV2_morphle/Marlin/src/module/thermistor/thermistor_2000.h", "C++", 0, -37, 0, 0, 0, -22, -2, -61
"/home/sanjay/Desktop/Bitbucket/MarlinV2_morphle/Marlin/src/module/thermistor/thermistor_201.h", "C++", 0, -33, 0, 0, 0, -22, -3, -58
"/home/sanjay/Desktop/Bitbucket/MarlinV2_morphle/Marlin/src/module/thermistor/thermistor_202.h", "C++", 0, -64, 0, 0, 0, -4, -2, -70
"/home/sanjay/Desktop/Bitbucket/MarlinV2_morphle/Marlin/src/module/thermistor/thermistor_21.h", "C++", 0, -51, 0, 0, 0, -23, -5, -79
"/home/sanjay/Desktop/Bitbucket/MarlinV2_morphle/Marlin/src/module/thermistor/thermistor_22.h", "C++", 0, -49, 0, 0, 0, -22, -2, -73
"/home/sanjay/Desktop/Bitbucket/MarlinV2_morphle/Marlin/src/module/thermistor/thermistor_23.h", "C++", 0, -105, 0, 0, 0, -22, -2, -129
"/home/sanjay/Desktop/Bitbucket/MarlinV2_morphle/Marlin/src/module/thermistor/thermistor_3.h", "C++", 0, -31, 0, 0, 0, -22, -2, -55
"/home/sanjay/Desktop/Bitbucket/MarlinV2_morphle/Marlin/src/module/thermistor/thermistor_30.h", "C++", 0, -37, 0, 0, 0, -28, -2, -67
"/home/sanjay/Desktop/Bitbucket/MarlinV2_morphle/Marlin/src/module/thermistor/thermistor_331.h", "C++", 0, -68, 0, 0, 0, -22, -3, -93
"/home/sanjay/Desktop/Bitbucket/MarlinV2_morphle/Marlin/src/module/thermistor/thermistor_332.h", "C++", 0, -26, 0, 0, 0, -22, -3, -51
"/home/sanjay/Desktop/Bitbucket/MarlinV2_morphle/Marlin/src/module/thermistor/thermistor_4.h", "C++", 0, -23, 0, 0, 0, -22, -2, -47
"/home/sanjay/Desktop/Bitbucket/MarlinV2_morphle/Marlin/src/module/thermistor/thermistor_5.h", "C++", 0, -35, 0, 0, 0, -26, -2, -63
"/home/sanjay/Desktop/Bitbucket/MarlinV2_morphle/Marlin/src/module/thermistor/thermistor_501.h", "C++", 0, -35, 0, 0, 0, -22, -2, -59
"/home/sanjay/Desktop/Bitbucket/MarlinV2_morphle/Marlin/src/module/thermistor/thermistor_502.h", "C++", 0, -36, 0, 0, 0, -23, -2, -61
"/home/sanjay/Desktop/Bitbucket/MarlinV2_morphle/Marlin/src/module/thermistor/thermistor_503.h", "C++", 0, -33, 0, 0, 0, -23, -2, -58
"/home/sanjay/Desktop/Bitbucket/MarlinV2_morphle/Marlin/src/module/thermistor/thermistor_504.h", "C++", 0, -70, 0, 0, 0, -22, -2, -94
"/home/sanjay/Desktop/Bitbucket/MarlinV2_morphle/Marlin/src/module/thermistor/thermistor_505.h", "C++", 0, -59, 0, 0, 0, -22, -2, -83
"/home/sanjay/Desktop/Bitbucket/MarlinV2_morphle/Marlin/src/module/thermistor/thermistor_51.h", "C++", 0, -56, 0, 0, 0, -26, -2, -84
"/home/sanjay/Desktop/Bitbucket/MarlinV2_morphle/Marlin/src/module/thermistor/thermistor_512.h", "C++", 0, -63, 0, 0, 0, -22, -3, -88
"/home/sanjay/Desktop/Bitbucket/MarlinV2_morphle/Marlin/src/module/thermistor/thermistor_52.h", "C++", 0, -35, 0, 0, 0, -26, -2, -63
"/home/sanjay/Desktop/Bitbucket/MarlinV2_morphle/Marlin/src/module/thermistor/thermistor_55.h", "C++", 0, -35, 0, 0, 0, -26, -2, -63
"/home/sanjay/Desktop/Bitbucket/MarlinV2_morphle/Marlin/src/module/thermistor/thermistor_6.h", "C++", 0, -41, 0, 0, 0, -22, -2, -65
"/home/sanjay/Desktop/Bitbucket/MarlinV2_morphle/Marlin/src/module/thermistor/thermistor_60.h", "C++", 0, -75, 0, 0, 0, -31, -2, -108
"/home/sanjay/Desktop/Bitbucket/MarlinV2_morphle/Marlin/src/module/thermistor/thermistor_61.h", "C++", 0, -85, 0, 0, 0, -30, -2, -117
"/home/sanjay/Desktop/Bitbucket/MarlinV2_morphle/Marlin/src/module/thermistor/thermistor_66.h", "C++", 0, -97, 0, 0, 0, -22, -2, -121
"/home/sanjay/Desktop/Bitbucket/MarlinV2_morphle/Marlin/src/module/thermistor/thermistor_666.h", "C++", 0, -64, 0, 0, 0, -32, -3, -99
"/home/sanjay/Desktop/Bitbucket/MarlinV2_morphle/Marlin/src/module/thermistor/thermistor_67.h", "C++", 0, -58, 0, 0, 0, -22, -2, -82
"/home/sanjay/Desktop/Bitbucket/MarlinV2_morphle/Marlin/src/module/thermistor/thermistor_68.h", "C++", 0, -30, 0, 0, 0, -22, -3, -55
"/home/sanjay/Desktop/Bitbucket/MarlinV2_morphle/Marlin/src/module/thermistor/thermistor_7.h", "C++", 0, -61, 0, 0, 0, -22, -2, -85
"/home/sanjay/Desktop/Bitbucket/MarlinV2_morphle/Marlin/src/module/thermistor/thermistor_70.h", "C++", 0, -19, 0, 0, 0, -25, -3, -47
"/home/sanjay/Desktop/Bitbucket/MarlinV2_morphle/Marlin/src/module/thermistor/thermistor_71.h", "C++", 0, -66, 0, 0, 0, -27, -2, -95
"/home/sanjay/Desktop/Bitbucket/MarlinV2_morphle/Marlin/src/module/thermistor/thermistor_75.h", "C++", 0, -41, 0, 0, 0, -32, -8, -81
"/home/sanjay/Desktop/Bitbucket/MarlinV2_morphle/Marlin/src/module/thermistor/thermistor_8.h", "C++", 0, -23, 0, 0, 0, -22, -2, -47
"/home/sanjay/Desktop/Bitbucket/MarlinV2_morphle/Marlin/src/module/thermistor/thermistor_9.h", "C++", 0, -34, 0, 0, 0, -22, -2, -58
"/home/sanjay/Desktop/Bitbucket/MarlinV2_morphle/Marlin/src/module/thermistor/thermistor_99.h", "C++", 0, -39, 0, 0, 0, -22, -3, -64
"/home/sanjay/Desktop/Bitbucket/MarlinV2_morphle/Marlin/src/module/thermistor/thermistor_998.h", "C++", 0, -8, 0, 0, 0, -23, -3, -34
"/home/sanjay/Desktop/Bitbucket/MarlinV2_morphle/Marlin/src/module/thermistor/thermistor_999.h", "C++", 0, -8, 0, 0, 0, -23, -3, -34
"/home/sanjay/Desktop/Bitbucket/MarlinV2_morphle/Marlin/src/module/thermistor/thermistors.h", "C++", 0, -488, 0, 0, 0, -30, -29, -547
"/home/sanjay/Desktop/Bitbucket/MarlinV2_morphle/Marlin/src/module/tool_change.cpp", "C++", 0, -950, 0, 0, 0, -207, -354, -1511
"/home/sanjay/Desktop/Bitbucket/MarlinV2_morphle/Marlin/src/module/tool_change.h", "C++", 0, -83, 0, 0, 0, -26, -25, -134
"/home/sanjay/Desktop/Bitbucket/MarlinV2_morphle/Marlin/src/pins/esp32/env_validate.h", "C++", 0, -4, 0, 0, 0, -21, -2, -27
"/home/sanjay/Desktop/Bitbucket/MarlinV2_morphle/Marlin/src/pins/esp32/pins_E4D.h", "C++", 0, -41, 0, 0, 0, -49, -14, -104
"/home/sanjay/Desktop/Bitbucket/MarlinV2_morphle/Marlin/src/pins/esp32/pins_ENWI_ESPNP.h", "C++", 0, -52, 0, 0, 0, -48, -19, -119
"/home/sanjay/Desktop/Bitbucket/MarlinV2_morphle/Marlin/src/pins/esp32/pins_ESP32.h", "C++", 0, -30, 0, 0, 0, -44, -13, -87
"/home/sanjay/Desktop/Bitbucket/MarlinV2_morphle/Marlin/src/pins/esp32/pins_ESPA_common.h", "C++", 0, -30, 0, 0, 0, -40, -12, -82
"/home/sanjay/Desktop/Bitbucket/MarlinV2_morphle/Marlin/src/pins/esp32/pins_FYSETC_E4.h", "C++", 0, -22, 0, 0, 0, -41, -10, -73
"/home/sanjay/Desktop/Bitbucket/MarlinV2_morphle/Marlin/src/pins/esp32/pins_MKS_TINYBEE.h", "C++", 0, -98, 0, 0, 0, -71, -25, -194
"/home/sanjay/Desktop/Bitbucket/MarlinV2_morphle/Marlin/src/pins/esp32/pins_MRR_ESPA.h", "C++", 0, -10, 0, 0, 0, -41, -8, -59
"/home/sanjay/Desktop/Bitbucket/MarlinV2_morphle/Marlin/src/pins/esp32/pins_MRR_ESPE.h", "C++", 0, -65, 0, 0, 0, -69, -31, -165
"/home/sanjay/Desktop/Bitbucket/MarlinV2_morphle/Marlin/src/pins/esp32/pins_PANDA_M4.h", "C++", 0, -7, 0, 0, 0, -27, -5, -39
"/home/sanjay/Desktop/Bitbucket/MarlinV2_morphle/Marlin/src/pins/esp32/pins_PANDA_ZHU.h", "C++", 0, -20, 0, 0, 0, -31, -11, -62
"/home/sanjay/Desktop/Bitbucket/MarlinV2_morphle/Marlin/src/pins/esp32/pins_PANDA_common.h", "C++", 0, -58, 0, 0, 0, -51, -20, -129
"/home/sanjay/Desktop/Bitbucket/MarlinV2_morphle/Marlin/src/pins/esp32/pins_RESP32_CUSTOM.h", "C++", 0, -5, 0, 0, 0, -27, -6, -38
"/home/sanjay/Desktop/Bitbucket/MarlinV2_morphle/Marlin/src/pins/linux/pins_RAMPS_LINUX.h", "C++", 0, -472, 0, 0, 0, -120, -107, -699
"/home/sanjay/Desktop/Bitbucket/MarlinV2_morphle/Marlin/src/pins/lpc1768/env_validate.h", "C++", 0, -7, 0, 0, 0, -21, -3, -31
"/home/sanjay/Desktop/Bitbucket/MarlinV2_morphle/Marlin/src/pins/lpc1768/pins_AZSMZ_MINI.h", "C++", 0, -69, 0, 0, 0, -71, -20, -160
"/home/sanjay/Desktop/Bitbucket/MarlinV2_morphle/Marlin/src/pins/lpc1768/pins_BIQU_B300_V1.0.h", "C++", 0, -76, 0, 0, 0, -83, -22, -181
"/home/sanjay/Desktop/Bitbucket/MarlinV2_morphle/Marlin/src/pins/lpc1768/pins_BIQU_BQ111_A4.h", "C++", 0, -51, 0, 0, 0, -76, -23, -150
"/home/sanjay/Desktop/Bitbucket/MarlinV2_morphle/Marlin/src/pins/lpc1768/pins_BTT_SKR_V1_1.h", "C++", 0, -114, 0, 0, 0, -104, -38, -256
"/home/sanjay/Desktop/Bitbucket/MarlinV2_morphle/Marlin/src/pins/lpc1768/pins_BTT_SKR_V1_3.h", "C++", 0, -275, 0, 0, 0, -133, -79, -487
"/home/sanjay/Desktop/Bitbucket/MarlinV2_morphle/Marlin/src/pins/lpc1768/pins_BTT_SKR_V1_4.h", "C++", 0, -281, 0, 0, 0, -147, -85, -513
"/home/sanjay/Desktop/Bitbucket/MarlinV2_morphle/Marlin/src/pins/lpc1768/pins_BTT_SKR_common.h", "C++", 0, -123, 0, 0, 0, -66, -21, -210
"/home/sanjay/Desktop/Bitbucket/MarlinV2_morphle/Marlin/src/pins/lpc1768/pins_EMOTRONIC.h", "C++", 0, -80, 0, 0, 0, -49, -21, -150
"/home/sanjay/Desktop/Bitbucket/MarlinV2_morphle/Marlin/src/pins/lpc1768/pins_GMARSH_X6_REV1.h", "C++", 0, -86, 0, 0, 0, -58, -31, -175
"/home/sanjay/Desktop/Bitbucket/MarlinV2_morphle/Marlin/src/pins/lpc1768/pins_MKS_SBASE.h", "C++", 0, -172, 0, 0, 0, -165, -51, -388
"/home/sanjay/Desktop/Bitbucket/MarlinV2_morphle/Marlin/src/pins/lpc1768/pins_MKS_SGEN_L.h", "C++", 0, -255, 0, 0, 0, -90, -72, -417
"/home/sanjay/Desktop/Bitbucket/MarlinV2_morphle/Marlin/src/pins/lpc1768/pins_RAMPS_RE_ARM.h", "C++", 0, -277, 0, 0, 0, -150, -69, -496
"/home/sanjay/Desktop/Bitbucket/MarlinV2_morphle/Marlin/src/pins/lpc1768/pins_SELENA_COMPACT.h", "C++", 0, -54, 0, 0, 0, -43, -20, -117
"/home/sanjay/Desktop/Bitbucket/MarlinV2_morphle/Marlin/src/pins/lpc1769/env_validate.h", "C++", 0, -4, 0, 0, 0, -21, -2, -27
"/home/sanjay/Desktop/Bitbucket/MarlinV2_morphle/Marlin/src/pins/lpc1769/pins_AZTEEG_X5_GT.h", "C++", 0, -63, 0, 0, 0, -43, -19, -125
"/home/sanjay/Desktop/Bitbucket/MarlinV2_morphle/Marlin/src/pins/lpc1769/pins_AZTEEG_X5_MINI.h", "C++", 0, -114, 0, 0, 0, -62, -36, -212
"/home/sanjay/Desktop/Bitbucket/MarlinV2_morphle/Marlin/src/pins/lpc1769/pins_AZTEEG_X5_MINI_WIFI.h", "C++", 0, -10, 0, 0, 0, -27, -6, -43
"/home/sanjay/Desktop/Bitbucket/MarlinV2_morphle/Marlin/src/pins/lpc1769/pins_BTT_SKR_E3_TURBO.h", "C++", 0, -153, 0, 0, 0, -88, -51, -292
"/home/sanjay/Desktop/Bitbucket/MarlinV2_morphle/Marlin/src/pins/lpc1769/pins_BTT_SKR_V1_4_TURBO.h", "C++", 0, -4, 0, 0, 0, -27, -4, -35
"/home/sanjay/Desktop/Bitbucket/MarlinV2_morphle/Marlin/src/pins/lpc1769/pins_COHESION3D_MINI.h", "C++", 0, -87, 0, 0, 0, -65, -24, -176
"/home/sanjay/Desktop/Bitbucket/MarlinV2_morphle/Marlin/src/pins/lpc1769/pins_COHESION3D_REMIX.h", "C++", 0, -138, 0, 0, 0, -114, -35, -287
"/home/sanjay/Desktop/Bitbucket/MarlinV2_morphle/Marlin/src/pins/lpc1769/pins_FLY_CDY.h", "C++", 0, -112, 0, 0, 0, -46, -26, -184
"/home/sanjay/Desktop/Bitbucket/MarlinV2_morphle/Marlin/src/pins/lpc1769/pins_MKS_SGEN.h", "C++", 0, -18, 0, 0, 0, -31, -10, -59
"/home/sanjay/Desktop/Bitbucket/MarlinV2_morphle/Marlin/src/pins/lpc1769/pins_MKS_SGEN_L_V2.h", "C++", 0, -279, 0, 0, 0, -99, -76, -454
"/home/sanjay/Desktop/Bitbucket/MarlinV2_morphle/Marlin/src/pins/lpc1769/pins_SMOOTHIEBOARD.h", "C++", 0, -80, 0, 0, 0, -71, -29, -180
"/home/sanjay/Desktop/Bitbucket/MarlinV2_morphle/Marlin/src/pins/lpc1769/pins_TH3D_EZBOARD.h", "C++", 0, -105, 0, 0, 0, -90, -33, -228
"/home/sanjay/Desktop/Bitbucket/MarlinV2_morphle/Marlin/src/pins/mega/env_validate.h", "C++", 0, -9, 0, 0, 0, -21, -3, -33
"/home/sanjay/Desktop/Bitbucket/MarlinV2_morphle/Marlin/src/pins/mega/pins_CHEAPTRONIC.h", "C++", 0, -27, 0, 0, 0, -40, -12, -79
"/home/sanjay/Desktop/Bitbucket/MarlinV2_morphle/Marlin/src/pins/mega/pins_CHEAPTRONICv2.h", "C++", 0, -72, 0, 0, 0, -47, -20, -139
"/home/sanjay/Desktop/Bitbucket/MarlinV2_morphle/Marlin/src/pins/mega/pins_CNCONTROLS_11.h", "C++", 0, -74, 0, 0, 0, -61, -28, -163
"/home/sanjay/Desktop/Bitbucket/MarlinV2_morphle/Marlin/src/pins/mega/pins_CNCONTROLS_12.h", "C++", 0, -79, 0, 0, 0, -62, -29, -170
"/home/sanjay/Desktop/Bitbucket/MarlinV2_morphle/Marlin/src/pins/mega/pins_CNCONTROLS_15.h", "C++", 0, -53, 0, 0, 0, -55, -19, -127
"/home/sanjay/Desktop/Bitbucket/MarlinV2_morphle/Marlin/src/pins/mega/pins_EINSTART-S.h", "C++", 0, -38, 0, 0, 0, -55, -20, -113
"/home/sanjay/Desktop/Bitbucket/MarlinV2_morphle/Marlin/src/pins/mega/pins_ELEFU_3.h", "C++", 0, -68, 0, 0, 0, -55, -28, -151
"/home/sanjay/Desktop/Bitbucket/MarlinV2_morphle/Marlin/src/pins/mega/pins_GT2560_REV_A.h", "C++", 0, -98, 0, 0, 0, -42, -30, -170
"/home/sanjay/Desktop/Bitbucket/MarlinV2_morphle/Marlin/src/pins/mega/pins_GT2560_REV_A_PLUS.h", "C++", 0, -6, 0, 0, 0, -24, -5, -35
"/home/sanjay/Desktop/Bitbucket/MarlinV2_morphle/Marlin/src/pins/mega/pins_GT2560_REV_B.h", "C++", 0, -3, 0, 0, 0, -24, -4, -31
"/home/sanjay/Desktop/Bitbucket/MarlinV2_morphle/Marlin/src/pins/mega/pins_GT2560_V3.h", "C++", 0, -139, 0, 0, 0, -56, -23, -218
"/home/sanjay/Desktop/Bitbucket/MarlinV2_morphle/Marlin/src/pins/mega/pins_GT2560_V3_A20.h", "C++", 0, -12, 0, 0, 0, -24, -6, -42
"/home/sanjay/Desktop/Bitbucket/MarlinV2_morphle/Marlin/src/pins/mega/pins_GT2560_V3_MC2.h", "C++", 0, -7, 0, 0, 0, -24, -5, -36
"/home/sanjay/Desktop/Bitbucket/MarlinV2_morphle/Marlin/src/pins/mega/pins_GT2560_V4.h", "C++", 0, -3, 0, 0, 0, -24, -4, -31
"/home/sanjay/Desktop/Bitbucket/MarlinV2_morphle/Marlin/src/pins/mega/pins_GT2560_V4_A20.h", "C++", 0, -13, 0, 0, 0, -24, -7, -44
"/home/sanjay/Desktop/Bitbucket/MarlinV2_morphle/Marlin/src/pins/mega/pins_HJC2560C_REV2.h", "C++", 0, -81, 0, 0, 0, -60, -31, -172
"/home/sanjay/Desktop/Bitbucket/MarlinV2_morphle/Marlin/src/pins/mega/pins_INTAMSYS40.h", "C++", 0, -62, 0, 0, 0, -62, -26, -150
"/home/sanjay/Desktop/Bitbucket/MarlinV2_morphle/Marlin/src/pins/mega/pins_LEAPFROG.h", "C++", 0, -37, 0, 0, 0, -40, -15, -92
"/home/sanjay/Desktop/Bitbucket/MarlinV2_morphle/Marlin/src/pins/mega/pins_LEAPFROG_XEED2015.h", "C++", 0, -38, 0, 0, 0, -56, -20, -114
"/home/sanjay/Desktop/Bitbucket/MarlinV2_morphle/Marlin/src/pins/mega/pins_MALYAN_M180.h", "C++", 0, -40, 0, 0, 0, -45, -16, -101
"/home/sanjay/Desktop/Bitbucket/MarlinV2_morphle/Marlin/src/pins/mega/pins_MEGACONTROLLER.h", "C++", 0, -81, 0, 0, 0, -52, -32, -165
"/home/sanjay/Desktop/Bitbucket/MarlinV2_morphle/Marlin/src/pins/mega/pins_MEGATRONICS.h", "C++", 0, -62, 0, 0, 0, -49, -22, -133
"/home/sanjay/Desktop/Bitbucket/MarlinV2_morphle/Marlin/src/pins/mega/pins_MEGATRONICS_2.h", "C++", 0, -80, 0, 0, 0, -50, -24, -154
"/home/sanjay/Desktop/Bitbucket/MarlinV2_morphle/Marlin/src/pins/mega/pins_MEGATRONICS_3.h", "C++", 0, -113, 0, 0, 0, -53, -28, -194
"/home/sanjay/Desktop/Bitbucket/MarlinV2_morphle/Marlin/src/pins/mega/pins_MIGHTYBOARD_REVE.h", "C++", 0, -130, 0, 0, 0, -101, -48, -279
"/home/sanjay/Desktop/Bitbucket/MarlinV2_morphle/Marlin/src/pins/mega/pins_MINITRONICS.h", "C++", 0, -68, 0, 0, 0, -51, -24, -143
"/home/sanjay/Desktop/Bitbucket/MarlinV2_morphle/Marlin/src/pins/mega/pins_OVERLORD.h", "C++", 0, -73, 0, 0, 0, -50, -22, -145
"/home/sanjay/Desktop/Bitbucket/MarlinV2_morphle/Marlin/src/pins/mega/pins_PICA.h", "C++", 0, -72, 0, 0, 0, -59, -23, -154
"/home/sanjay/Desktop/Bitbucket/MarlinV2_morphle/Marlin/src/pins/mega/pins_PICAOLD.h", "C++", 0, -6, 0, 0, 0, -21, -3, -30
"/home/sanjay/Desktop/Bitbucket/MarlinV2_morphle/Marlin/src/pins/mega/pins_PROTONEER_CNC_SHIELD_V3.h", "C++", 0, -19, 0, 0, 0, -48, -11, -78
"/home/sanjay/Desktop/Bitbucket/MarlinV2_morphle/Marlin/src/pins/mega/pins_SILVER_GATE.h", "C++", 0, -63, 0, 0, 0, -21, -19, -103
"/home/sanjay/Desktop/Bitbucket/MarlinV2_morphle/Marlin/src/pins/mega/pins_WANHAO_ONEPLUS.h", "C++", 0, -44, 0, 0, 0, -49, -17, -110
"/home/sanjay/Desktop/Bitbucket/MarlinV2_morphle/Marlin/src/pins/mega/pins_WEEDO_62A.h", "C++", 0, -44, 0, 0, 0, -46, -17, -107
"/home/sanjay/Desktop/Bitbucket/MarlinV2_morphle/Marlin/src/pins/pins.h", "C++", 0, -751, 0, 0, 0, -101, -52, -904
"/home/sanjay/Desktop/Bitbucket/MarlinV2_morphle/Marlin/src/pins/pinsDebug.h", "C++", 0, -211, 0, 0, 0, -52, -31, -294
"/home/sanjay/Desktop/Bitbucket/MarlinV2_morphle/Marlin/src/pins/pinsDebug_list.h", "C++", 0, -1739, 0, 0, 0, -47, -11, -1797
"/home/sanjay/Desktop/Bitbucket/MarlinV2_morphle/Marlin/src/pins/pins_postprocess.h", "C++", 0, -1317, 0, 0, 0, -65, -54, -1436
"/home/sanjay/Desktop/Bitbucket/MarlinV2_morphle/Marlin/src/pins/rambo/env_validate.h", "C++", 0, -4, 0, 0, 0, -21, -2, -27
"/home/sanjay/Desktop/Bitbucket/MarlinV2_morphle/Marlin/src/pins/rambo/pins_EINSY_RAMBO.h", "C++", 0, -114, 0, 0, 0, -65, -38, -217
"/home/sanjay/Desktop/Bitbucket/MarlinV2_morphle/Marlin/src/pins/rambo/pins_EINSY_RETRO.h", "C++", 0, -112, 0, 0, 0, -62, -37, -211
"/home/sanjay/Desktop/Bitbucket/MarlinV2_morphle/Marlin/src/pins/rambo/pins_MINIRAMBO.h", "C++", 0, -111, 0, 0, 0, -56, -36, -203
"/home/sanjay/Desktop/Bitbucket/MarlinV2_morphle/Marlin/src/pins/rambo/pins_RAMBO.h", "C++", 0, -144, 0, 0, 0, -88, -49, -281
"/home/sanjay/Desktop/Bitbucket/MarlinV2_morphle/Marlin/src/pins/rambo/pins_RAMBO_THINKERV2.h", "C++", 0, -25, 0, 0, 0, -27, -9, -61
"/home/sanjay/Desktop/Bitbucket/MarlinV2_morphle/Marlin/src/pins/rambo/pins_SCOOVO_X9H.h", "C++", 0, -83, 0, 0, 0, -50, -26, -159
"/home/sanjay/Desktop/Bitbucket/MarlinV2_morphle/Marlin/src/pins/ramps/env_validate.h", "C++", 0, -12, 0, 0, 0, -21, -3, -36
"/home/sanjay/Desktop/Bitbucket/MarlinV2_morphle/Marlin/src/pins/ramps/pins_3DRAG.h", "C++", 0, -77, 0, 0, 0, -75, -22, -174
"/home/sanjay/Desktop/Bitbucket/MarlinV2_morphle/Marlin/src/pins/ramps/pins_AZTEEG_X3.h", "C++", 0, -45, 0, 0, 0, -36, -17, -98
"/home/sanjay/Desktop/Bitbucket/MarlinV2_morphle/Marlin/src/pins/ramps/pins_AZTEEG_X3_PRO.h", "C++", 0, -89, 0, 0, 0, -65, -25, -179
"/home/sanjay/Desktop/Bitbucket/MarlinV2_morphle/Marlin/src/pins/ramps/pins_BAM_DICE_DUE.h", "C++", 0, -11, 0, 0, 0, -30, -7, -48
"/home/sanjay/Desktop/Bitbucket/MarlinV2_morphle/Marlin/src/pins/ramps/pins_BIQU_KFB_2.h", "C++", 0, -7, 0, 0, 0, -28, -6, -41
"/home/sanjay/Desktop/Bitbucket/MarlinV2_morphle/Marlin/src/pins/ramps/pins_BQ_ZUM_MEGA_3D.h", "C++", 0, -50, 0, 0, 0, -59, -18, -127
"/home/sanjay/Desktop/Bitbucket/MarlinV2_morphle/Marlin/src/pins/ramps/pins_COPYMASTER_3D.h", "C++", 0, -7, 0, 0, 0, -24, -4, -35
"/home/sanjay/Desktop/Bitbucket/MarlinV2_morphle/Marlin/src/pins/ramps/pins_DAGOMA_F5.h", "C++", 0, -26, 0, 0, 0, -31, -10, -67
"/home/sanjay/Desktop/Bitbucket/MarlinV2_morphle/Marlin/src/pins/ramps/pins_DUPLICATOR_I3_PLUS.h", "C++", 0, -43, 0, 0, 0, -125, -16, -184
"/home/sanjay/Desktop/Bitbucket/MarlinV2_morphle/Marlin/src/pins/ramps/pins_FELIX2.h", "C++", 0, -15, 0, 0, 0, -37, -12, -64
"/home/sanjay/Desktop/Bitbucket/MarlinV2_morphle/Marlin/src/pins/ramps/pins_FORMBOT_RAPTOR.h", "C++", 0, -105, 0, 0, 0, -52, -25, -182
"/home/sanjay/Desktop/Bitbucket/MarlinV2_morphle/Marlin/src/pins/ramps/pins_FORMBOT_RAPTOR2.h", "C++", 0, -36, 0, 0, 0, -27, -12, -75
"/home/sanjay/Desktop/Bitbucket/MarlinV2_morphle/Marlin/src/pins/ramps/pins_FORMBOT_TREX2PLUS.h", "C++", 0, -107, 0, 0, 0, -56, -27, -190
"/home/sanjay/Desktop/Bitbucket/MarlinV2_morphle/Marlin/src/pins/ramps/pins_FORMBOT_TREX3.h", "C++", 0, -110, 0, 0, 0, -52, -26, -188
"/home/sanjay/Desktop/Bitbucket/MarlinV2_morphle/Marlin/src/pins/ramps/pins_FYSETC_F6_13.h", "C++", 0, -190, 0, 0, 0, -72, -40, -302
"/home/sanjay/Desktop/Bitbucket/MarlinV2_morphle/Marlin/src/pins/ramps/pins_FYSETC_F6_14.h", "C++", 0, -18, 0, 0, 0, -27, -11, -56
"/home/sanjay/Desktop/Bitbucket/MarlinV2_morphle/Marlin/src/pins/ramps/pins_K8200.h", "C++", 0, -5, 0, 0, 0, -25, -4, -34
"/home/sanjay/Desktop/Bitbucket/MarlinV2_morphle/Marlin/src/pins/ramps/pins_K8400.h", "C++", 0, -15, 0, 0, 0, -43, -9, -67
"/home/sanjay/Desktop/Bitbucket/MarlinV2_morphle/Marlin/src/pins/ramps/pins_K8600.h", "C++", 0, -39, 0, 0, 0, -46, -16, -101
"/home/sanjay/Desktop/Bitbucket/MarlinV2_morphle/Marlin/src/pins/ramps/pins_K8800.h", "C++", 0, -48, 0, 0, 0, -46, -23, -117
"/home/sanjay/Desktop/Bitbucket/MarlinV2_morphle/Marlin/src/pins/ramps/pins_LONGER3D_LKx_PRO.h", "C++", 0, -54, 0, 0, 0, -50, -18, -122
"/home/sanjay/Desktop/Bitbucket/MarlinV2_morphle/Marlin/src/pins/ramps/pins_MAKEBOARD_MINI.h", "C++", 0, -6, 0, 0, 0, -24, -4, -34
"/home/sanjay/Desktop/Bitbucket/MarlinV2_morphle/Marlin/src/pins/ramps/pins_MKS_BASE_10.h", "C++", 0, -7, 0, 0, 0, -26, -5, -38
"/home/sanjay/Desktop/Bitbucket/MarlinV2_morphle/Marlin/src/pins/ramps/pins_MKS_BASE_14.h", "C++", 0, -24, 0, 0, 0, -136, -11, -171
"/home/sanjay/Desktop/Bitbucket/MarlinV2_morphle/Marlin/src/pins/ramps/pins_MKS_BASE_15.h", "C++", 0, -7, 0, 0, 0, -24, -5, -36
"/home/sanjay/Desktop/Bitbucket/MarlinV2_morphle/Marlin/src/pins/ramps/pins_MKS_BASE_16.h", "C++", 0, -23, 0, 0, 0, -30, -7, -60
"/home/sanjay/Desktop/Bitbucket/MarlinV2_morphle/Marlin/src/pins/ramps/pins_MKS_BASE_HEROIC.h", "C++", 0, -3, 0, 0, 0, -30, -4, -37
"/home/sanjay/Desktop/Bitbucket/MarlinV2_morphle/Marlin/src/pins/ramps/pins_MKS_BASE_common.h", "C++", 0, -33, 0, 0, 0, -34, -9, -76
"/home/sanjay/Desktop/Bitbucket/MarlinV2_morphle/Marlin/src/pins/ramps/pins_MKS_GEN_13.h", "C++", 0, -35, 0, 0, 0, -83, -13, -131
"/home/sanjay/Desktop/Bitbucket/MarlinV2_morphle/Marlin/src/pins/ramps/pins_MKS_GEN_L.h", "C++", 0, -17, 0, 0, 0, -33, -10, -60
"/home/sanjay/Desktop/Bitbucket/MarlinV2_morphle/Marlin/src/pins/ramps/pins_MKS_GEN_L_V2.h", "C++", 0, -42, 0, 0, 0, -33, -15, -90
"/home/sanjay/Desktop/Bitbucket/MarlinV2_morphle/Marlin/src/pins/ramps/pins_MKS_GEN_L_V21.h", "C++", 0, -42, 0, 0, 0, -33, -11, -86
"/home/sanjay/Desktop/Bitbucket/MarlinV2_morphle/Marlin/src/pins/ramps/pins_ORTUR_4.h", "C++", 0, -49, 0, 0, 0, -39, -18, -106
"/home/sanjay/Desktop/Bitbucket/MarlinV2_morphle/Marlin/src/pins/ramps/pins_PXMALION_CORE_I3.h", "C++", 0, -35, 0, 0, 0, -40, -12, -87
"/home/sanjay/Desktop/Bitbucket/MarlinV2_morphle/Marlin/src/pins/ramps/pins_RAMPS.h", "C++", 0, -573, 0, 0, 0, -199, -139, -911
"/home/sanjay/Desktop/Bitbucket/MarlinV2_morphle/Marlin/src/pins/ramps/pins_RAMPS_13.h", "C++", 0, -6, 0, 0, 0, -32, -5, -43
"/home/sanjay/Desktop/Bitbucket/MarlinV2_morphle/Marlin/src/pins/ramps/pins_RAMPS_CREALITY.h", "C++", 0, -36, 0, 0, 0, -25, -12, -73
"/home/sanjay/Desktop/Bitbucket/MarlinV2_morphle/Marlin/src/pins/ramps/pins_RAMPS_ENDER_4.h", "C++", 0, -12, 0, 0, 0, -24, -6, -42
"/home/sanjay/Desktop/Bitbucket/MarlinV2_morphle/Marlin/src/pins/ramps/pins_RAMPS_OLD.h", "C++", 0, -53, 0, 0, 0, -48, -17, -118
"/home/sanjay/Desktop/Bitbucket/MarlinV2_morphle/Marlin/src/pins/ramps/pins_RAMPS_PLUS.h", "C++", 0, -33, 0, 0, 0, -51, -11, -95
"/home/sanjay/Desktop/Bitbucket/MarlinV2_morphle/Marlin/src/pins/ramps/pins_RAMPS_S_12.h", "C++", 0, -171, 0, 0, 0, -77, -33, -281
"/home/sanjay/Desktop/Bitbucket/MarlinV2_morphle/Marlin/src/pins/ramps/pins_RIGIDBOARD.h", "C++", 0, -55, 0, 0, 0, -51, -24, -130
"/home/sanjay/Desktop/Bitbucket/MarlinV2_morphle/Marlin/src/pins/ramps/pins_RIGIDBOARD_V2.h", "C++", 0, -15, 0, 0, 0, -29, -9, -53
"/home/sanjay/Desktop/Bitbucket/MarlinV2_morphle/Marlin/src/pins/ramps/pins_RL200.h", "C++", 0, -20, 0, 0, 0, -25, -8, -53
"/home/sanjay/Desktop/Bitbucket/MarlinV2_morphle/Marlin/src/pins/ramps/pins_RUMBA.h", "C++", 0, -157, 0, 0, 0, -60, -34, -251
"/home/sanjay/Desktop/Bitbucket/MarlinV2_morphle/Marlin/src/pins/ramps/pins_RUMBA_RAISE3D.h", "C++", 0, -6, 0, 0, 0, -22, -4, -32
"/home/sanjay/Desktop/Bitbucket/MarlinV2_morphle/Marlin/src/pins/ramps/pins_SAINSMART_2IN1.h", "C++", 0, -9, 0, 0, 0, -28, -6, -43
"/home/sanjay/Desktop/Bitbucket/MarlinV2_morphle/Marlin/src/pins/ramps/pins_TANGO.h", "C++", 0, -22, 0, 0, 0, -24, -8, -54
"/home/sanjay/Desktop/Bitbucket/MarlinV2_morphle/Marlin/src/pins/ramps/pins_TENLOG_D3_HERO.h", "C++", 0, -63, 0, 0, 0, -97, -28, -188
"/home/sanjay/Desktop/Bitbucket/MarlinV2_morphle/Marlin/src/pins/ramps/pins_TRIGORILLA_13.h", "C++", 0, -12, 0, 0, 0, -24, -8, -44
"/home/sanjay/Desktop/Bitbucket/MarlinV2_morphle/Marlin/src/pins/ramps/pins_TRIGORILLA_14.h", "C++", 0, -81, 0, 0, 0, -51, -16, -148
"/home/sanjay/Desktop/Bitbucket/MarlinV2_morphle/Marlin/src/pins/ramps/pins_TRONXY_V3_1_0.h", "C++", 0, -9, 0, 0, 0, -264, -8, -281
"/home/sanjay/Desktop/Bitbucket/MarlinV2_morphle/Marlin/src/pins/ramps/pins_TT_OSCAR.h", "C++", 0, -288, 0, 0, 0, -124, -98, -510
"/home/sanjay/Desktop/Bitbucket/MarlinV2_morphle/Marlin/src/pins/ramps/pins_ULTIMAIN_2.h", "C++", 0, -67, 0, 0, 0, -54, -21, -142
"/home/sanjay/Desktop/Bitbucket/MarlinV2_morphle/Marlin/src/pins/ramps/pins_ULTIMAKER.h", "C++", 0, -76, 0, 0, 0, -60, -31, -167
"/home/sanjay/Desktop/Bitbucket/MarlinV2_morphle/Marlin/src/pins/ramps/pins_ULTIMAKER_OLD.h", "C++", 0, -126, 0, 0, 0, -114, -33, -273
"/home/sanjay/Desktop/Bitbucket/MarlinV2_morphle/Marlin/src/pins/ramps/pins_VORON.h", "C++", 0, -14, 0, 0, 0, -34, -8, -56
"/home/sanjay/Desktop/Bitbucket/MarlinV2_morphle/Marlin/src/pins/ramps/pins_ZRIB_V20.h", "C++", 0, -51, 0, 0, 0, -28, -9, -88
"/home/sanjay/Desktop/Bitbucket/MarlinV2_morphle/Marlin/src/pins/ramps/pins_ZRIB_V52.h", "C++", 0, -13, 0, 0, 0, -138, -9, -160
"/home/sanjay/Desktop/Bitbucket/MarlinV2_morphle/Marlin/src/pins/ramps/pins_ZRIB_V53.h", "C++", 0, -262, 0, 0, 0, -209, -41, -512
"/home/sanjay/Desktop/Bitbucket/MarlinV2_morphle/Marlin/src/pins/ramps/pins_Z_BOLT_X_SERIES.h", "C++", 0, -203, 0, 0, 0, -71, -30, -304
"/home/sanjay/Desktop/Bitbucket/MarlinV2_morphle/Marlin/src/pins/sam/env_validate.h", "C++", 0, -10, 0, 0, 0, -21, -3, -34
"/home/sanjay/Desktop/Bitbucket/MarlinV2_morphle/Marlin/src/pins/sam/pins_ADSK.h", "C++", 0, -53, 0, 0, 0, -128, -27, -208
"/home/sanjay/Desktop/Bitbucket/MarlinV2_morphle/Marlin/src/pins/sam/pins_ALLIGATOR_R2.h", "C++", 0, -78, 0, 0, 0, -53, -27, -158
"/home/sanjay/Desktop/Bitbucket/MarlinV2_morphle/Marlin/src/pins/sam/pins_ARCHIM1.h", "C++", 0, -100, 0, 0, 0, -72, -34, -206
"/home/sanjay/Desktop/Bitbucket/MarlinV2_morphle/Marlin/src/pins/sam/pins_ARCHIM2.h", "C++", 0, -146, 0, 0, 0, -79, -38, -263
"/home/sanjay/Desktop/Bitbucket/MarlinV2_morphle/Marlin/src/pins/sam/pins_CNCONTROLS_15D.h", "C++", 0, -62, 0, 0, 0, -55, -21, -138
"/home/sanjay/Desktop/Bitbucket/MarlinV2_morphle/Marlin/src/pins/sam/pins_DUE3DOM.h", "C++", 0, -90, 0, 0, 0, -46, -36, -172
"/home/sanjay/Desktop/Bitbucket/MarlinV2_morphle/Marlin/src/pins/sam/pins_DUE3DOM_MINI.h", "C++", 0, -89, 0, 0, 0, -47, -37, -173
"/home/sanjay/Desktop/Bitbucket/MarlinV2_morphle/Marlin/src/pins/sam/pins_KRATOS32.h", "C++", 0, -102, 0, 0, 0, -48, -30, -180
"/home/sanjay/Desktop/Bitbucket/MarlinV2_morphle/Marlin/src/pins/sam/pins_PRINTRBOARD_G2.h", "C++", 0, -59, 0, 0, 0, -86, -27, -172
"/home/sanjay/Desktop/Bitbucket/MarlinV2_morphle/Marlin/src/pins/sam/pins_RADDS.h", "C++", 0, -177, 0, 0, 0, -63, -57, -297
"/home/sanjay/Desktop/Bitbucket/MarlinV2_morphle/Marlin/src/pins/sam/pins_RAMPS4DUE.h", "C++", 0, -7, 0, 0, 0, -41, -5, -53
"/home/sanjay/Desktop/Bitbucket/MarlinV2_morphle/Marlin/src/pins/sam/pins_RAMPS_DUO.h", "C++", 0, -56, 0, 0, 0, -49, -27, -132
"/home/sanjay/Desktop/Bitbucket/MarlinV2_morphle/Marlin/src/pins/sam/pins_RAMPS_FD_V1.h", "C++", 0, -148, 0, 0, 0, -81, -36, -265
"/home/sanjay/Desktop/Bitbucket/MarlinV2_morphle/Marlin/src/pins/sam/pins_RAMPS_FD_V2.h", "C++", 0, -17, 0, 0, 0, -27, -9, -53
"/home/sanjay/Desktop/Bitbucket/MarlinV2_morphle/Marlin/src/pins/sam/pins_RAMPS_SMART.h", "C++", 0, -46, 0, 0, 0, -82, -15, -143
"/home/sanjay/Desktop/Bitbucket/MarlinV2_morphle/Marlin/src/pins/sam/pins_RURAMPS4D_11.h", "C++", 0, -153, 0, 0, 0, -94, -46, -293
"/home/sanjay/Desktop/Bitbucket/MarlinV2_morphle/Marlin/src/pins/sam/pins_RURAMPS4D_13.h", "C++", 0, -147, 0, 0, 0, -87, -44, -278
"/home/sanjay/Desktop/Bitbucket/MarlinV2_morphle/Marlin/src/pins/sam/pins_ULTRATRONICS_PRO.h", "C++", 0, -98, 0, 0, 0, -50, -29, -177
"/home/sanjay/Desktop/Bitbucket/MarlinV2_morphle/Marlin/src/pins/samd/pins_BRICOLEMON_LITE_V1_0.h", "C++", 0, -184, 0, 0, 0, -318, -115, -617
"/home/sanjay/Desktop/Bitbucket/MarlinV2_morphle/Marlin/src/pins/samd/pins_BRICOLEMON_V1_0.h", "C++", 0, -212, 0, 0, 0, -337, -128, -677
"/home/sanjay/Desktop/Bitbucket/MarlinV2_morphle/Marlin/src/pins/samd/pins_RAMPS_144.h", "C++", 0, -237, 0, 0, 0, -231, -104, -572
"/home/sanjay/Desktop/Bitbucket/MarlinV2_morphle/Marlin/src/pins/sanguino/env_validate.h", "C++", 0, -19, 0, 0, 0, -21, -3, -43
"/home/sanjay/Desktop/Bitbucket/MarlinV2_morphle/Marlin/src/pins/sanguino/pins_ANET_10.h", "C++", 0, -73, 0, 0, 0, -200, -33, -306
"/home/sanjay/Desktop/Bitbucket/MarlinV2_morphle/Marlin/src/pins/sanguino/pins_AZTEEG_X1.h", "C++", 0, -3, 0, 0, 0, -24, -4, -31
"/home/sanjay/Desktop/Bitbucket/MarlinV2_morphle/Marlin/src/pins/sanguino/pins_GEN3_MONOLITHIC.h", "C++", 0, -23, 0, 0, 0, -61, -15, -99
"/home/sanjay/Desktop/Bitbucket/MarlinV2_morphle/Marlin/src/pins/sanguino/pins_GEN3_PLUS.h", "C++", 0, -25, 0, 0, 0, -60, -14, -99
"/home/sanjay/Desktop/Bitbucket/MarlinV2_morphle/Marlin/src/pins/sanguino/pins_GEN6.h", "C++", 0, -37, 0, 0, 0, -66, -18, -121
"/home/sanjay/Desktop/Bitbucket/MarlinV2_morphle/Marlin/src/pins/sanguino/pins_GEN6_DELUXE.h", "C++", 0, -3, 0, 0, 0, -45, -7, -55
"/home/sanjay/Desktop/Bitbucket/MarlinV2_morphle/Marlin/src/pins/sanguino/pins_GEN7_12.h", "C++", 0, -53, 0, 0, 0, -72, -22, -147
"/home/sanjay/Desktop/Bitbucket/MarlinV2_morphle/Marlin/src/pins/sanguino/pins_GEN7_13.h", "C++", 0, -4, 0, 0, 0, -45, -6, -55
"/home/sanjay/Desktop/Bitbucket/MarlinV2_morphle/Marlin/src/pins/sanguino/pins_GEN7_14.h", "C++", 0, -34, 0, 0, 0, -67, -19, -120
"/home/sanjay/Desktop/Bitbucket/MarlinV2_morphle/Marlin/src/pins/sanguino/pins_GEN7_CUSTOM.h", "C++", 0, -42, 0, 0, 0, -77, -21, -140
"/home/sanjay/Desktop/Bitbucket/MarlinV2_morphle/Marlin/src/pins/sanguino/pins_MELZI.h", "C++", 0, -17, 0, 0, 0, -25, -6, -48
"/home/sanjay/Desktop/Bitbucket/MarlinV2_morphle/Marlin/src/pins/sanguino/pins_MELZI_CREALITY.h", "C++", 0, -39, 0, 0, 0, -92, -11, -142
"/home/sanjay/Desktop/Bitbucket/MarlinV2_morphle/Marlin/src/pins/sanguino/pins_MELZI_MAKR3D.h", "C++", 0, -3, 0, 0, 0, -24, -3, -30
"/home/sanjay/Desktop/Bitbucket/MarlinV2_morphle/Marlin/src/pins/sanguino/pins_MELZI_MALYAN.h", "C++", 0, -16, 0, 0, 0, -24, -6, -46
"/home/sanjay/Desktop/Bitbucket/MarlinV2_morphle/Marlin/src/pins/sanguino/pins_MELZI_TRONXY.h", "C++", 0, -29, 0, 0, 0, -25, -7, -61
"/home/sanjay/Desktop/Bitbucket/MarlinV2_morphle/Marlin/src/pins/sanguino/pins_MELZI_V2.h", "C++", 0, -8, 0, 0, 0, -25, -5, -38
"/home/sanjay/Desktop/Bitbucket/MarlinV2_morphle/Marlin/src/pins/sanguino/pins_OMCA.h", "C++", 0, -42, 0, 0, 0, -88, -20, -150
"/home/sanjay/Desktop/Bitbucket/MarlinV2_morphle/Marlin/src/pins/sanguino/pins_OMCA_A.h", "C++", 0, -32, 0, 0, 0, -86, -18, -136
"/home/sanjay/Desktop/Bitbucket/MarlinV2_morphle/Marlin/src/pins/sanguino/pins_SANGUINOLOLU_11.h", "C++", 0, -140, 0, 0, 0, -113, -64, -317
"/home/sanjay/Desktop/Bitbucket/MarlinV2_morphle/Marlin/src/pins/sanguino/pins_SANGUINOLOLU_12.h", "C++", 0, -6, 0, 0, 0, -33, -4, -43
"/home/sanjay/Desktop/Bitbucket/MarlinV2_morphle/Marlin/src/pins/sanguino/pins_SETHI.h", "C++", 0, -38, 0, 0, 0, -67, -19, -124
"/home/sanjay/Desktop/Bitbucket/MarlinV2_morphle/Marlin/src/pins/sanguino/pins_STB_11.h", "C++", 0, -3, 0, 0, 0, -24, -4, -31
"/home/sanjay/Desktop/Bitbucket/MarlinV2_morphle/Marlin/src/pins/sanguino/pins_ZMIB_V2.h", "C++", 0, -97, 0, 0, 0, -111, -25, -233
"/home/sanjay/Desktop/Bitbucket/MarlinV2_morphle/Marlin/src/pins/sensitive_pins.h", "C++", 0, -768, 0, 0, 0, -46, -83, -897
"/home/sanjay/Desktop/Bitbucket/MarlinV2_morphle/Marlin/src/pins/stm32f0/pins_MALYAN_M200_V2.h", "C++", 0, -6, 0, 0, 0, -21, -4, -31
"/home/sanjay/Desktop/Bitbucket/MarlinV2_morphle/Marlin/src/pins/stm32f0/pins_MALYAN_M300.h", "C++", 0, -35, 0, 0, 0, -42, -14, -91
"/home/sanjay/Desktop/Bitbucket/MarlinV2_morphle/Marlin/src/pins/stm32f1/env_validate.h", "C++", 0, -9, 0, 0, 0, -21, -3, -33
"/home/sanjay/Desktop/Bitbucket/MarlinV2_morphle/Marlin/src/pins/stm32f1/pins_BEAST.h", "C++", 0, -74, 0, 0, 0, -48, -24, -146
"/home/sanjay/Desktop/Bitbucket/MarlinV2_morphle/Marlin/src/pins/stm32f1/pins_BTT_SKR_CR6.h", "C++", 0, -91, 0, 0, 0, -62, -34, -187
"/home/sanjay/Desktop/Bitbucket/MarlinV2_morphle/Marlin/src/pins/stm32f1/pins_BTT_SKR_E3_DIP.h", "C++", 0, -131, 0, 0, 0, -112, -50, -293
"/home/sanjay/Desktop/Bitbucket/MarlinV2_morphle/Marlin/src/pins/stm32f1/pins_BTT_SKR_MINI_E3_V1_0.h", "C++", 0, -21, 0, 0, 0, -26, -5, -52
"/home/sanjay/Desktop/Bitbucket/MarlinV2_morphle/Marlin/src/pins/stm32f1/pins_BTT_SKR_MINI_E3_V1_2.h", "C++", 0, -17, 0, 0, 0, -25, -9, -51
"/home/sanjay/Desktop/Bitbucket/MarlinV2_morphle/Marlin/src/pins/stm32f1/pins_BTT_SKR_MINI_E3_V2_0.h", "C++", 0, -44, 0, 0, 0, -28, -13, -85
"/home/sanjay/Desktop/Bitbucket/MarlinV2_morphle/Marlin/src/pins/stm32f1/pins_BTT_SKR_MINI_E3_common.h", "C++", 0, -149, 0, 0, 0, -175, -63, -387
"/home/sanjay/Desktop/Bitbucket/MarlinV2_morphle/Marlin/src/pins/stm32f1/pins_BTT_SKR_MINI_MZ_V1_0.h", "C++", 0, -3, 0, 0, 0, -21, -3, -27
"/home/sanjay/Desktop/Bitbucket/MarlinV2_morphle/Marlin/src/pins/stm32f1/pins_BTT_SKR_MINI_V1_1.h", "C++", 0, -138, 0, 0, 0, -70, -50, -258
"/home/sanjay/Desktop/Bitbucket/MarlinV2_morphle/Marlin/src/pins/stm32f1/pins_CCROBOT_MEEB_3DP.h", "C++", 0, -85, 0, 0, 0, -70, -31, -186
"/home/sanjay/Desktop/Bitbucket/MarlinV2_morphle/Marlin/src/pins/stm32f1/pins_CHITU3D.h", "C++", 0, -151, 0, 0, 0, -60, -55, -266
"/home/sanjay/Desktop/Bitbucket/MarlinV2_morphle/Marlin/src/pins/stm32f1/pins_CHITU3D_V5.h", "C++", 0, -4, 0, 0, 0, -21, -4, -29
"/home/sanjay/Desktop/Bitbucket/MarlinV2_morphle/Marlin/src/pins/stm32f1/pins_CHITU3D_V6.h", "C++", 0, -9, 0, 0, 0, -21, -5, -35
"/home/sanjay/Desktop/Bitbucket/MarlinV2_morphle/Marlin/src/pins/stm32f1/pins_CHITU3D_V9.h", "C++", 0, -14, 0, 0, 0, -21, -6, -41
"/home/sanjay/Desktop/Bitbucket/MarlinV2_morphle/Marlin/src/pins/stm32f1/pins_CHITU3D_common.h", "C++", 0, -93, 0, 0, 0, -58, -27, -178
"/home/sanjay/Desktop/Bitbucket/MarlinV2_morphle/Marlin/src/pins/stm32f1/pins_CREALITY_V24S1.h", "C++", 0, -5, 0, 0, 0, -27, -5, -37
"/home/sanjay/Desktop/Bitbucket/MarlinV2_morphle/Marlin/src/pins/stm32f1/pins_CREALITY_V24S1_301.h", "C++", 0, -36, 0, 0, 0, -45, -14, -95
"/home/sanjay/Desktop/Bitbucket/MarlinV2_morphle/Marlin/src/pins/stm32f1/pins_CREALITY_V25S1.h", "C++", 0, -68, 0, 0, 0, -62, -23, -153
"/home/sanjay/Desktop/Bitbucket/MarlinV2_morphle/Marlin/src/pins/stm32f1/pins_CREALITY_V4.h", "C++", 0, -141, 0, 0, 0, -77, -34, -252
"/home/sanjay/Desktop/Bitbucket/MarlinV2_morphle/Marlin/src/pins/stm32f1/pins_CREALITY_V4210.h", "C++", 0, -116, 0, 0, 0, -76, -36, -228
"/home/sanjay/Desktop/Bitbucket/MarlinV2_morphle/Marlin/src/pins/stm32f1/pins_CREALITY_V422.h", "C++", 0, -4, 0, 0, 0, -24, -4, -32
"/home/sanjay/Desktop/Bitbucket/MarlinV2_morphle/Marlin/src/pins/stm32f1/pins_CREALITY_V423.h", "C++", 0, -9, 0, 0, 0, -30, -6, -45
"/home/sanjay/Desktop/Bitbucket/MarlinV2_morphle/Marlin/src/pins/stm32f1/pins_CREALITY_V425.h", "C++", 0, -27, 0, 0, 0, -39, -12, -78
"/home/sanjay/Desktop/Bitbucket/MarlinV2_morphle/Marlin/src/pins/stm32f1/pins_CREALITY_V427.h", "C++", 0, -12, 0, 0, 0, -27, -7, -46
"/home/sanjay/Desktop/Bitbucket/MarlinV2_morphle/Marlin/src/pins/stm32f1/pins_CREALITY_V431.h", "C++", 0, -14, 0, 0, 0, -27, -11, -52
"/home/sanjay/Desktop/Bitbucket/MarlinV2_morphle/Marlin/src/pins/stm32f1/pins_CREALITY_V452.h", "C++", 0, -14, 0, 0, 0, -24, -7, -45
"/home/sanjay/Desktop/Bitbucket/MarlinV2_morphle/Marlin/src/pins/stm32f1/pins_CREALITY_V453.h", "C++", 0, -14, 0, 0, 0, -24, -7, -45
"/home/sanjay/Desktop/Bitbucket/MarlinV2_morphle/Marlin/src/pins/stm32f1/pins_CREALITY_V45x.h", "C++", 0, -42, 0, 0, 0, -52, -21, -115
"/home/sanjay/Desktop/Bitbucket/MarlinV2_morphle/Marlin/src/pins/stm32f1/pins_ERYONE_ERY32_MINI.h", "C++", 0, -110, 0, 0, 0, -62, -25, -197
"/home/sanjay/Desktop/Bitbucket/MarlinV2_morphle/Marlin/src/pins/stm32f1/pins_FLSUN_HISPEED.h", "C++", 0, -157, 0, 0, 0, -130, -42, -329
"/home/sanjay/Desktop/Bitbucket/MarlinV2_morphle/Marlin/src/pins/stm32f1/pins_FLY_MINI.h", "C++", 0, -114, 0, 0, 0, -52, -25, -191
"/home/sanjay/Desktop/Bitbucket/MarlinV2_morphle/Marlin/src/pins/stm32f1/pins_FYSETC_AIO_II.h", "C++", 0, -114, 0, 0, 0, -62, -32, -208
"/home/sanjay/Desktop/Bitbucket/MarlinV2_morphle/Marlin/src/pins/stm32f1/pins_FYSETC_CHEETAH.h", "C++", 0, -107, 0, 0, 0, -64, -30, -201
"/home/sanjay/Desktop/Bitbucket/MarlinV2_morphle/Marlin/src/pins/stm32f1/pins_FYSETC_CHEETAH_V12.h", "C++", 0, -22, 0, 0, 0, -25, -13, -60
"/home/sanjay/Desktop/Bitbucket/MarlinV2_morphle/Marlin/src/pins/stm32f1/pins_GTM32_MINI.h", "C++", 0, -93, 0, 0, 0, -110, -33, -236
"/home/sanjay/Desktop/Bitbucket/MarlinV2_morphle/Marlin/src/pins/stm32f1/pins_GTM32_MINI_A30.h", "C++", 0, -91, 0, 0, 0, -106, -33, -230
"/home/sanjay/Desktop/Bitbucket/MarlinV2_morphle/Marlin/src/pins/stm32f1/pins_GTM32_PRO_VB.h", "C++", 0, -95, 0, 0, 0, -113, -33, -241
"/home/sanjay/Desktop/Bitbucket/MarlinV2_morphle/Marlin/src/pins/stm32f1/pins_GTM32_PRO_VD.h", "C++", 0, -3, 0, 0, 0, -24, -4, -31
"/home/sanjay/Desktop/Bitbucket/MarlinV2_morphle/Marlin/src/pins/stm32f1/pins_GTM32_REV_B.h", "C++", 0, -90, 0, 0, 0, -108, -35, -233
"/home/sanjay/Desktop/Bitbucket/MarlinV2_morphle/Marlin/src/pins/stm32f1/pins_JGAURORA_A5S_A1.h", "C++", 0, -59, 0, 0, 0, -63, -26, -148
"/home/sanjay/Desktop/Bitbucket/MarlinV2_morphle/Marlin/src/pins/stm32f1/pins_LONGER3D_LK.h", "C++", 0, -112, 0, 0, 0, -69, -32, -213
"/home/sanjay/Desktop/Bitbucket/MarlinV2_morphle/Marlin/src/pins/stm32f1/pins_MALYAN_M200.h", "C++", 0, -36, 0, 0, 0, -43, -17, -96
"/home/sanjay/Desktop/Bitbucket/MarlinV2_morphle/Marlin/src/pins/stm32f1/pins_MINGDA_MPX_ARM_MINI.h", "C++", 0, -74, 0, 0, 0, -60, -28, -162
"/home/sanjay/Desktop/Bitbucket/MarlinV2_morphle/Marlin/src/pins/stm32f1/pins_MKS_ROBIN.h", "C++", 0, -128, 0, 0, 0, -119, -36, -283
"/home/sanjay/Desktop/Bitbucket/MarlinV2_morphle/Marlin/src/pins/stm32f1/pins_MKS_ROBIN_E3.h", "C++", 0, -8, 0, 0, 0, -24, -5, -37
"/home/sanjay/Desktop/Bitbucket/MarlinV2_morphle/Marlin/src/pins/stm32f1/pins_MKS_ROBIN_E3D.h", "C++", 0, -31, 0, 0, 0, -30, -7, -68
"/home/sanjay/Desktop/Bitbucket/MarlinV2_morphle/Marlin/src/pins/stm32f1/pins_MKS_ROBIN_E3D_V1_1.h", "C++", 0, -31, 0, 0, 0, -30, -7, -68
"/home/sanjay/Desktop/Bitbucket/MarlinV2_morphle/Marlin/src/pins/stm32f1/pins_MKS_ROBIN_E3P.h", "C++", 0, -224, 0, 0, 0, -104, -68, -396
"/home/sanjay/Desktop/Bitbucket/MarlinV2_morphle/Marlin/src/pins/stm32f1/pins_MKS_ROBIN_E3_V1_1.h", "C++", 0, -8, 0, 0, 0, -24, -5, -37
"/home/sanjay/Desktop/Bitbucket/MarlinV2_morphle/Marlin/src/pins/stm32f1/pins_MKS_ROBIN_E3_V1_1_common.h", "C++", 0, -10, 0, 0, 0, -25, -5, -40
"/home/sanjay/Desktop/Bitbucket/MarlinV2_morphle/Marlin/src/pins/stm32f1/pins_MKS_ROBIN_E3_common.h", "C++", 0, -144, 0, 0, 0, -79, -43, -266
"/home/sanjay/Desktop/Bitbucket/MarlinV2_morphle/Marlin/src/pins/stm32f1/pins_MKS_ROBIN_LITE.h", "C++", 0, -92, 0, 0, 0, -55, -29, -176
"/home/sanjay/Desktop/Bitbucket/MarlinV2_morphle/Marlin/src/pins/stm32f1/pins_MKS_ROBIN_LITE3.h", "C++", 0, -78, 0, 0, 0, -50, -32, -160
"/home/sanjay/Desktop/Bitbucket/MarlinV2_morphle/Marlin/src/pins/stm32f1/pins_MKS_ROBIN_MINI.h", "C++", 0, -110, 0, 0, 0, -63, -34, -207
"/home/sanjay/Desktop/Bitbucket/MarlinV2_morphle/Marlin/src/pins/stm32f1/pins_MKS_ROBIN_NANO.h", "C++", 0, -9, 0, 0, 0, -34, -9, -52
"/home/sanjay/Desktop/Bitbucket/MarlinV2_morphle/Marlin/src/pins/stm32f1/pins_MKS_ROBIN_NANO_V2.h", "C++", 0, -232, 0, 0, 0, -96, -68, -396
"/home/sanjay/Desktop/Bitbucket/MarlinV2_morphle/Marlin/src/pins/stm32f1/pins_MKS_ROBIN_NANO_common.h", "C++", 0, -116, 0, 0, 0, -65, -31, -212
"/home/sanjay/Desktop/Bitbucket/MarlinV2_morphle/Marlin/src/pins/stm32f1/pins_MKS_ROBIN_PRO.h", "C++", 0, -189, 0, 0, 0, -81, -49, -319
"/home/sanjay/Desktop/Bitbucket/MarlinV2_morphle/Marlin/src/pins/stm32f1/pins_MORPHEUS.h", "C++", 0, -32, 0, 0, 0, -47, -15, -94
"/home/sanjay/Desktop/Bitbucket/MarlinV2_morphle/Marlin/src/pins/stm32f1/pins_PANDA_PI_V29.h", "C++", 0, -91, 0, 0, 0, -97, -37, -225
"/home/sanjay/Desktop/Bitbucket/MarlinV2_morphle/Marlin/src/pins/stm32f1/pins_STM32F1R.h", "C++", 0, -70, 0, 0, 0, -47, -22, -139
"/home/sanjay/Desktop/Bitbucket/MarlinV2_morphle/Marlin/src/pins/stm32f1/pins_STM3R_MINI.h", "C++", 0, -83, 0, 0, 0, -49, -28, -160
"/home/sanjay/Desktop/Bitbucket/MarlinV2_morphle/Marlin/src/pins/stm32f1/pins_TRIGORILLA_PRO.h", "C++", 0, -112, 0, 0, 0, -68, -29, -209
"/home/sanjay/Desktop/Bitbucket/MarlinV2_morphle/Marlin/src/pins/stm32f1/pins_ZM3E2_V1_0.h", "C++", 0, -82, 0, 0, 0, -122, -32, -236
"/home/sanjay/Desktop/Bitbucket/MarlinV2_morphle/Marlin/src/pins/stm32f1/pins_ZM3E4_V1_0.h", "C++", 0, -182, 0, 0, 0, -134, -41, -357
"/home/sanjay/Desktop/Bitbucket/MarlinV2_morphle/Marlin/src/pins/stm32f1/pins_ZM3E4_V2_0.h", "C++", 0, -157, 0, 0, 0, -135, -38, -330
"/home/sanjay/Desktop/Bitbucket/MarlinV2_morphle/Marlin/src/pins/stm32f4/env_validate.h", "C++", 0, -5, 0, 0, 0, -21, -3, -29
"/home/sanjay/Desktop/Bitbucket/MarlinV2_morphle/Marlin/src/pins/stm32f4/pins_ANET_ET4.h", "C++", 0, -122, 0, 0, 0, -67, -30, -219
"/home/sanjay/Desktop/Bitbucket/MarlinV2_morphle/Marlin/src/pins/stm32f4/pins_ANET_ET4P.h", "C++", 0, -6, 0, 0, 0, -24, -4, -34
"/home/sanjay/Desktop/Bitbucket/MarlinV2_morphle/Marlin/src/pins/stm32f4/pins_ARMED.h", "C++", 0, -136, 0, 0, 0, -56, -37, -229
"/home/sanjay/Desktop/Bitbucket/MarlinV2_morphle/Marlin/src/pins/stm32f4/pins_ARTILLERY_RUBY.h", "C++", 0, -110, 0, 0, 0, -50, -25, -185
"/home/sanjay/Desktop/Bitbucket/MarlinV2_morphle/Marlin/src/pins/stm32f4/pins_BLACK_STM32F407VE.h", "C++", 0, -78, 0, 0, 0, -54, -25, -157
"/home/sanjay/Desktop/Bitbucket/MarlinV2_morphle/Marlin/src/pins/stm32f4/pins_BTT_BTT002_V1_0.h", "C++", 0, -192, 0, 0, 0, -90, -55, -337
"/home/sanjay/Desktop/Bitbucket/MarlinV2_morphle/Marlin/src/pins/stm32f4/pins_BTT_E3_RRF.h", "C++", 0, -190, 0, 0, 0, -157, -74, -421
"/home/sanjay/Desktop/Bitbucket/MarlinV2_morphle/Marlin/src/pins/stm32f4/pins_BTT_GTR_V1_0.h", "C++", 0, -318, 0, 0, 0, -95, -82, -495
"/home/sanjay/Desktop/Bitbucket/MarlinV2_morphle/Marlin/src/pins/stm32f4/pins_BTT_OCTOPUS_PRO_V1_0.h", "C++", 0, -16, 0, 0, 0, -24, -5, -45
"/home/sanjay/Desktop/Bitbucket/MarlinV2_morphle/Marlin/src/pins/stm32f4/pins_BTT_OCTOPUS_V1_0.h", "C++", 0, -8, 0, 0, 0, -24, -4, -36
"/home/sanjay/Desktop/Bitbucket/MarlinV2_morphle/Marlin/src/pins/stm32f4/pins_BTT_OCTOPUS_V1_1.h", "C++", 0, -8, 0, 0, 0, -24, -4, -36
"/home/sanjay/Desktop/Bitbucket/MarlinV2_morphle/Marlin/src/pins/stm32f4/pins_BTT_OCTOPUS_V1_common.h", "C++", 0, -338, 0, 0, 0, -133, -75, -546
"/home/sanjay/Desktop/Bitbucket/MarlinV2_morphle/Marlin/src/pins/stm32f4/pins_BTT_SKR_PRO_V1_1.h", "C++", 0, -6, 0, 0, 0, -21, -4, -31
"/home/sanjay/Desktop/Bitbucket/MarlinV2_morphle/Marlin/src/pins/stm32f4/pins_BTT_SKR_PRO_V1_2.h", "C++", 0, -6, 0, 0, 0, -21, -4, -31
"/home/sanjay/Desktop/Bitbucket/MarlinV2_morphle/Marlin/src/pins/stm32f4/pins_BTT_SKR_PRO_common.h", "C++", 0, -346, 0, 0, 0, -146, -77, -569
"/home/sanjay/Desktop/Bitbucket/MarlinV2_morphle/Marlin/src/pins/stm32f4/pins_BTT_SKR_V2_0_REV_A.h", "C++", 0, -5, 0, 0, 0, -21, -4, -30
"/home/sanjay/Desktop/Bitbucket/MarlinV2_morphle/Marlin/src/pins/stm32f4/pins_BTT_SKR_V2_0_REV_B.h", "C++", 0, -3, 0, 0, 0, -21, -3, -27
"/home/sanjay/Desktop/Bitbucket/MarlinV2_morphle/Marlin/src/pins/stm32f4/pins_BTT_SKR_V2_0_common.h", "C++", 0, -359, 0, 0, 0, -147, -75, -581
"/home/sanjay/Desktop/Bitbucket/MarlinV2_morphle/Marlin/src/pins/stm32f4/pins_CREALITY_V24S1_301F4.h", "C++", 0, -10, 0, 0, 0, -24, -5, -39
"/home/sanjay/Desktop/Bitbucket/MarlinV2_morphle/Marlin/src/pins/stm32f4/pins_FLYF407ZG.h", "C++", 0, -190, 0, 0, 0, -74, -49, -313
"/home/sanjay/Desktop/Bitbucket/MarlinV2_morphle/Marlin/src/pins/stm32f4/pins_FYSETC_CHEETAH_V20.h", "C++", 0, -146, 0, 0, 0, -69, -45, -260
"/home/sanjay/Desktop/Bitbucket/MarlinV2_morphle/Marlin/src/pins/stm32f4/pins_FYSETC_S6.h", "C++", 0, -220, 0, 0, 0, -74, -47, -341
"/home/sanjay/Desktop/Bitbucket/MarlinV2_morphle/Marlin/src/pins/stm32f4/pins_FYSETC_S6_V2_0.h", "C++", 0, -34, 0, 0, 0, -31, -7, -72
"/home/sanjay/Desktop/Bitbucket/MarlinV2_morphle/Marlin/src/pins/stm32f4/pins_FYSETC_SPIDER.h", "C++", 0, -63, 0, 0, 0, -42, -19, -124
"/home/sanjay/Desktop/Bitbucket/MarlinV2_morphle/Marlin/src/pins/stm32f4/pins_FYSETC_SPIDER_V2_2.h", "C++", 0, -9, 0, 0, 0, -21, -5, -35
"/home/sanjay/Desktop/Bitbucket/MarlinV2_morphle/Marlin/src/pins/stm32f4/pins_LERDGE_K.h", "C++", 0, -145, 0, 0, 0, -94, -34, -273
"/home/sanjay/Desktop/Bitbucket/MarlinV2_morphle/Marlin/src/pins/stm32f4/pins_LERDGE_S.h", "C++", 0, -116, 0, 0, 0, -78, -39, -233
"/home/sanjay/Desktop/Bitbucket/MarlinV2_morphle/Marlin/src/pins/stm32f4/pins_LERDGE_X.h", "C++", 0, -82, 0, 0, 0, -65, -29, -176
"/home/sanjay/Desktop/Bitbucket/MarlinV2_morphle/Marlin/src/pins/stm32f4/pins_MKS_EAGLE.h", "C++", 0, -10, 0, 0, 0, -21, -5, -36
"/home/sanjay/Desktop/Bitbucket/MarlinV2_morphle/Marlin/src/pins/stm32f4/pins_MKS_MONSTER8_V1.h", "C++", 0, -16, 0, 0, 0, -30, -6, -52
"/home/sanjay/Desktop/Bitbucket/MarlinV2_morphle/Marlin/src/pins/stm32f4/pins_MKS_MONSTER8_V2.h", "C++", 0, -20, 0, 0, 0, -31, -7, -58
"/home/sanjay/Desktop/Bitbucket/MarlinV2_morphle/Marlin/src/pins/stm32f4/pins_MKS_MONSTER8_common.h", "C++", 0, -243, 0, 0, 0, -69, -57, -369
"/home/sanjay/Desktop/Bitbucket/MarlinV2_morphle/Marlin/src/pins/stm32f4/pins_MKS_ROBIN2.h", "C++", 0, -46, 0, 0, 0, -39, -17, -102
"/home/sanjay/Desktop/Bitbucket/MarlinV2_morphle/Marlin/src/pins/stm32f4/pins_MKS_ROBIN_NANO_V1_3_F4.h", "C++", 0, -8, 0, 0, 0, -31, -7, -46
"/home/sanjay/Desktop/Bitbucket/MarlinV2_morphle/Marlin/src/pins/stm32f4/pins_MKS_ROBIN_NANO_V3.h", "C++", 0, -40, 0, 0, 0, -25, -8, -73
"/home/sanjay/Desktop/Bitbucket/MarlinV2_morphle/Marlin/src/pins/stm32f4/pins_MKS_ROBIN_NANO_V3_common.h", "C++", 0, -230, 0, 0, 0, -101, -61, -392
"/home/sanjay/Desktop/Bitbucket/MarlinV2_morphle/Marlin/src/pins/stm32f4/pins_MKS_ROBIN_PRO_V2.h", "C++", 0, -201, 0, 0, 0, -121, -57, -379
"/home/sanjay/Desktop/Bitbucket/MarlinV2_morphle/Marlin/src/pins/stm32f4/pins_OPULO_LUMEN_REV3.h", "C++", 0, -93, 0, 0, 0, -78, -36, -207
"/home/sanjay/Desktop/Bitbucket/MarlinV2_morphle/Marlin/src/pins/stm32f4/pins_RUMBA32_AUS3D.h", "C++", 0, -32, 0, 0, 0, -32, -14, -78
"/home/sanjay/Desktop/Bitbucket/MarlinV2_morphle/Marlin/src/pins/stm32f4/pins_RUMBA32_BTT.h", "C++", 0, -25, 0, 0, 0, -30, -13, -68
"/home/sanjay/Desktop/Bitbucket/MarlinV2_morphle/Marlin/src/pins/stm32f4/pins_RUMBA32_MKS.h", "C++", 0, -24, 0, 0, 0, -51, -13, -88
"/home/sanjay/Desktop/Bitbucket/MarlinV2_morphle/Marlin/src/pins/stm32f4/pins_RUMBA32_common.h", "C++", 0, -95, 0, 0, 0, -55, -30, -180
"/home/sanjay/Desktop/Bitbucket/MarlinV2_morphle/Marlin/src/pins/stm32f4/pins_STEVAL_3DP001V1.h", "C++", 0, -94, 0, 0, 0, -190, -42, -326
"/home/sanjay/Desktop/Bitbucket/MarlinV2_morphle/Marlin/src/pins/stm32f4/pins_TH3D_EZBOARD_V2.h", "C++", 0, -138, 0, 0, 0, -99, -39, -276
"/home/sanjay/Desktop/Bitbucket/MarlinV2_morphle/Marlin/src/pins/stm32f4/pins_VAKE403D.h", "C++", 0, -108, 0, 0, 0, -80, -39, -227
"/home/sanjay/Desktop/Bitbucket/MarlinV2_morphle/Marlin/src/pins/stm32f7/pins_NUCLEO_F767ZI.h", "C++", 0, -77, 0, 0, 0, -96, -25, -198
"/home/sanjay/Desktop/Bitbucket/MarlinV2_morphle/Marlin/src/pins/stm32f7/pins_REMRAM_V1.h", "C++", 0, -71, 0, 0, 0, -46, -20, -137
"/home/sanjay/Desktop/Bitbucket/MarlinV2_morphle/Marlin/src/pins/stm32g0/pins_BTT_SKR_MINI_E3_V3_0.h", "C++", 0, -188, 0, 0, 0, -186, -66, -440
"/home/sanjay/Desktop/Bitbucket/MarlinV2_morphle/Marlin/src/pins/stm32h7/pins_BTT_SKR_SE_BX_V2.h", "C++", 0, -4, 0, 0, 0, -21, -4, -29
"/home/sanjay/Desktop/Bitbucket/MarlinV2_morphle/Marlin/src/pins/stm32h7/pins_BTT_SKR_SE_BX_V3.h", "C++", 0, -3, 0, 0, 0, -21, -3, -27
"/home/sanjay/Desktop/Bitbucket/MarlinV2_morphle/Marlin/src/pins/stm32h7/pins_BTT_SKR_SE_BX_common.h", "C++", 0, -132, 0, 0, 0, -67, -36, -235
"/home/sanjay/Desktop/Bitbucket/MarlinV2_morphle/Marlin/src/pins/stm32h7/pins_BTT_SKR_V3_0.h", "C++", 0, -3, 0, 0, 0, -21, -3, -27
"/home/sanjay/Desktop/Bitbucket/MarlinV2_morphle/Marlin/src/pins/stm32h7/pins_BTT_SKR_V3_0_EZ.h", "C++", 0, -3, 0, 0, 0, -21, -3, -27
"/home/sanjay/Desktop/Bitbucket/MarlinV2_morphle/Marlin/src/pins/stm32h7/pins_BTT_SKR_V3_0_common.h", "C++", 0, -363, 0, 0, 0, -145, -71, -579
"/home/sanjay/Desktop/Bitbucket/MarlinV2_morphle/Marlin/src/pins/teensy2/env_validate.h", "C++", 0, -5, 0, 0, 0, -21, -3, -29
"/home/sanjay/Desktop/Bitbucket/MarlinV2_morphle/Marlin/src/pins/teensy2/pins_5DPRINT.h", "C++", 0, -42, 0, 0, 0, -86, -19, -147
"/home/sanjay/Desktop/Bitbucket/MarlinV2_morphle/Marlin/src/pins/teensy2/pins_BRAINWAVE.h", "C++", 0, -32, 0, 0, 0, -78, -17, -127
"/home/sanjay/Desktop/Bitbucket/MarlinV2_morphle/Marlin/src/pins/teensy2/pins_BRAINWAVE_PRO.h", "C++", 0, -32, 0, 0, 0, -89, -16, -137
"/home/sanjay/Desktop/Bitbucket/MarlinV2_morphle/Marlin/src/pins/teensy2/pins_PRINTRBOARD.h", "C++", 0, -61, 0, 0, 0, -78, -32, -171
"/home/sanjay/Desktop/Bitbucket/MarlinV2_morphle/Marlin/src/pins/teensy2/pins_PRINTRBOARD_REVF.h", "C++", 0, -120, 0, 0, 0, -117, -44, -281
"/home/sanjay/Desktop/Bitbucket/MarlinV2_morphle/Marlin/src/pins/teensy2/pins_SAV_MKI.h", "C++", 0, -63, 0, 0, 0, -95, -26, -184
"/home/sanjay/Desktop/Bitbucket/MarlinV2_morphle/Marlin/src/pins/teensy2/pins_TEENSY2.h", "C++", 0, -45, 0, 0, 0, -124, -18, -187
"/home/sanjay/Desktop/Bitbucket/MarlinV2_morphle/Marlin/src/pins/teensy2/pins_TEENSYLU.h", "C++", 0, -46, 0, 0, 0, -98, -25, -169
"/home/sanjay/Desktop/Bitbucket/MarlinV2_morphle/Marlin/src/pins/teensy3/pins_TEENSY31_32.h", "C++", 0, -33, 0, 0, 0, -64, -16, -113
"/home/sanjay/Desktop/Bitbucket/MarlinV2_morphle/Marlin/src/pins/teensy3/pins_TEENSY35_36.h", "C++", 0, -59, 0, 0, 0, -76, -18, -153
"/home/sanjay/Desktop/Bitbucket/MarlinV2_morphle/Marlin/src/pins/teensy4/pins_T41U5XBB.h", "C++", 0, -36, 0, 0, 0, -75, -16, -127
"/home/sanjay/Desktop/Bitbucket/MarlinV2_morphle/Marlin/src/pins/teensy4/pins_TEENSY41.h", "C++", 0, -39, 0, 0, 0, -77, -16, -132
"/home/sanjay/Desktop/Bitbucket/MarlinV2_morphle/Marlin/src/sd/Sd2Card.cpp", "C++", 0, -425, 0, 0, 0, -170, -87, -682
"/home/sanjay/Desktop/Bitbucket/MarlinV2_morphle/Marlin/src/sd/Sd2Card.h", "C++", 0, -91, 0, 0, 0, -77, -30, -198
"/home/sanjay/Desktop/Bitbucket/MarlinV2_morphle/Marlin/src/sd/Sd2Card_sdio.h", "C++", 0, -27, 0, 0, 0, -21, -12, -60
"/home/sanjay/Desktop/Bitbucket/MarlinV2_morphle/Marlin/src/sd/SdBaseFile.cpp", "C++", 0, -1173, 0, 0, 0, -795, -269, -2237
"/home/sanjay/Desktop/Bitbucket/MarlinV2_morphle/Marlin/src/sd/SdBaseFile.h", "C++", 0, -145, 0, 0, 0, -207, -51, -403
"/home/sanjay/Desktop/Bitbucket/MarlinV2_morphle/Marlin/src/sd/SdFatConfig.h", "C++", 0, -13, 0, 0, 0, -85, -15, -113
"/home/sanjay/Desktop/Bitbucket/MarlinV2_morphle/Marlin/src/sd/SdFatStructs.h", "C++", 0, -159, 0, 0, 0, -408, -43, -610
"/home/sanjay/Desktop/Bitbucket/MarlinV2_morphle/Marlin/src/sd/SdFatUtil.cpp", "C++", 0, -19, 0, 0, 0, -33, -11, -63
"/home/sanjay/Desktop/Bitbucket/MarlinV2_morphle/Marlin/src/sd/SdFatUtil.h", "C++", 0, -5, 0, 0, 0, -33, -5, -43
"/home/sanjay/Desktop/Bitbucket/MarlinV2_morphle/Marlin/src/sd/SdFile.cpp", "C++", 0, -19, 0, 0, 0, -72, -12, -103
"/home/sanjay/Desktop/Bitbucket/MarlinV2_morphle/Marlin/src/sd/SdFile.h", "C++", 0, -17, 0, 0, 0, -33, -6, -56
"/home/sanjay/Desktop/Bitbucket/MarlinV2_morphle/Marlin/src/sd/SdInfo.h", "C++", 0, -128, 0, 0, 0, -128, -10, -266
"/home/sanjay/Desktop/Bitbucket/MarlinV2_morphle/Marlin/src/sd/SdVolume.cpp", "C++", 0, -256, 0, 0, 0, -95, -55, -406
"/home/sanjay/Desktop/Bitbucket/MarlinV2_morphle/Marlin/src/sd/SdVolume.h", "C++", 0, -105, 0, 0, 0, -74, -23, -202
"/home/sanjay/Desktop/Bitbucket/MarlinV2_morphle/Marlin/src/sd/cardreader.cpp", "C++", 0, -889, 0, 0, 0, -239, -216, -1344
"/home/sanjay/Desktop/Bitbucket/MarlinV2_morphle/Marlin/src/sd/cardreader.h", "C++", 0, -261, 0, 0, 0, -66, -62, -389
"/home/sanjay/Desktop/Bitbucket/MarlinV2_morphle/Marlin/src/sd/disk_io_driver.h", "C++", 0, -18, 0, 0, 0, -40, -10, -68
"/home/sanjay/Desktop/Bitbucket/MarlinV2_morphle/Marlin/src/sd/usb_flashdrive/Sd2Card_FlashDrive.cpp", "C++", 0, -225, 0, 0, 0, -49, -55, -329
"/home/sanjay/Desktop/Bitbucket/MarlinV2_morphle/Marlin/src/sd/usb_flashdrive/Sd2Card_FlashDrive.h", "C++", 0, -36, 0, 0, 0, -30, -15, -81
"/home/sanjay/Desktop/Bitbucket/MarlinV2_morphle/Marlin/src/sd/usb_flashdrive/lib-uhs2/Usb.cpp", "C++", 0, -472, 0, 0, 0, -201, -123, -796
"/home/sanjay/Desktop/Bitbucket/MarlinV2_morphle/Marlin/src/sd/usb_flashdrive/lib-uhs2/Usb.h", "C++", 0, -18, 0, 0, 0, -29, -7, -54
"/home/sanjay/Desktop/Bitbucket/MarlinV2_morphle/Marlin/src/sd/usb_flashdrive/lib-uhs2/UsbCore.h", "C++", 0, -211, 0, 0, 0, -46, -56, -313
"/home/sanjay/Desktop/Bitbucket/MarlinV2_morphle/Marlin/src/sd/usb_flashdrive/lib-uhs2/address.h", "C++", 0, -151, 0, 0, 0, -72, -49, -272
"/home/sanjay/Desktop/Bitbucket/MarlinV2_morphle/Marlin/src/sd/usb_flashdrive/lib-uhs2/confdescparser.h", "C++", 0, -140, 0, 0, 0, -38, -24, -202
"/home/sanjay/Desktop/Bitbucket/MarlinV2_morphle/Marlin/src/sd/usb_flashdrive/lib-uhs2/hexdump.h", "C++", 0, -35, 0, 0, 0, -24, -10, -69
"/home/sanjay/Desktop/Bitbucket/MarlinV2_morphle/Marlin/src/sd/usb_flashdrive/lib-uhs2/macros.h", "C++", 0, -45, 0, 0, 0, -35, -7, -87
"/home/sanjay/Desktop/Bitbucket/MarlinV2_morphle/Marlin/src/sd/usb_flashdrive/lib-uhs2/masstorage.cpp", "C++", 0, -698, 0, 0, 0, -344, -168, -1210
"/home/sanjay/Desktop/Bitbucket/MarlinV2_morphle/Marlin/src/sd/usb_flashdrive/lib-uhs2/masstorage.h", "C++", 0, -406, 0, 0, 0, -54, -100, -560
"/home/sanjay/Desktop/Bitbucket/MarlinV2_morphle/Marlin/src/sd/usb_flashdrive/lib-uhs2/max3421e.h", "C++", 0, -161, 0, 0, 0, -50, -32, -243
"/home/sanjay/Desktop/Bitbucket/MarlinV2_morphle/Marlin/src/sd/usb_flashdrive/lib-uhs2/message.cpp", "C++", 0, -75, 0, 0, 0, -30, -24, -129
"/home/sanjay/Desktop/Bitbucket/MarlinV2_morphle/Marlin/src/sd/usb_flashdrive/lib-uhs2/message.h", "C++", 0, -55, 0, 0, 0, -24, -7, -86
"/home/sanjay/Desktop/Bitbucket/MarlinV2_morphle/Marlin/src/sd/usb_flashdrive/lib-uhs2/parsetools.cpp", "C++", 0, -40, 0, 0, 0, -24, -14, -78
"/home/sanjay/Desktop/Bitbucket/MarlinV2_morphle/Marlin/src/sd/usb_flashdrive/lib-uhs2/parsetools.h", "C++", 0, -91, 0, 0, 0, -26, -29, -146
"/home/sanjay/Desktop/Bitbucket/MarlinV2_morphle/Marlin/src/sd/usb_flashdrive/lib-uhs2/printhex.h", "C++", 0, -48, 0, 0, 0, -24, -9, -81
"/home/sanjay/Desktop/Bitbucket/MarlinV2_morphle/Marlin/src/sd/usb_flashdrive/lib-uhs2/settings.h", "C++", 0, -123, 0, 0, 0, -79, -35, -237
"/home/sanjay/Desktop/Bitbucket/MarlinV2_morphle/Marlin/src/sd/usb_flashdrive/lib-uhs2/usb_ch9.h", "C++", 0, -109, 0, 0, 0, -38, -24, -171
"/home/sanjay/Desktop/Bitbucket/MarlinV2_morphle/Marlin/src/sd/usb_flashdrive/lib-uhs2/usbhost.cpp", "C++", 0, -126, 0, 0, 0, -46, -35, -207
"/home/sanjay/Desktop/Bitbucket/MarlinV2_morphle/Marlin/src/sd/usb_flashdrive/lib-uhs2/usbhost.h", "C++", 0, -25, 0, 0, 0, -21, -13, -59
"/home/sanjay/Desktop/Bitbucket/MarlinV2_morphle/Marlin/src/sd/usb_flashdrive/lib-uhs3/UHS_host/UHS_BULK_STORAGE/UHS_BULK_STORAGE.h", "C++", 0, -155, 0, 0, 0, -47, -48, -250
"/home/sanjay/Desktop/Bitbucket/MarlinV2_morphle/Marlin/src/sd/usb_flashdrive/lib-uhs3/UHS_host/UHS_BULK_STORAGE/UHS_BULK_STORAGE_INLINE.h", "C++", 0, -739, 0, 0, 0, -320, -147, -1206
"/home/sanjay/Desktop/Bitbucket/MarlinV2_morphle/Marlin/src/sd/usb_flashdrive/lib-uhs3/UHS_host/UHS_BULK_STORAGE/UHS_SCSI.h", "C++", 0, -235, 0, 0, 0, -38, -55, -328
"/home/sanjay/Desktop/Bitbucket/MarlinV2_morphle/Marlin/src/sd/usb_flashdrive/lib-uhs3/UHS_host/UHS_UNOFFICIAL_IDs.h", "C++", 0, -4, 0, 0, 0, -26, -4, -34
"/home/sanjay/Desktop/Bitbucket/MarlinV2_morphle/Marlin/src/sd/usb_flashdrive/lib-uhs3/UHS_host/UHS_USB_IDs.h", "C++", 0, -2955, 0, 0, 0, -36, -3, -2994
"/home/sanjay/Desktop/Bitbucket/MarlinV2_morphle/Marlin/src/sd/usb_flashdrive/lib-uhs3/UHS_host/UHS_UsbCore.h", "C++", 0, -167, 0, 0, 0, -116, -54, -337
"/home/sanjay/Desktop/Bitbucket/MarlinV2_morphle/Marlin/src/sd/usb_flashdrive/lib-uhs3/UHS_host/UHS_address.h", "C++", 0, -142, 0, 0, 0, -61, -46, -249
"/home/sanjay/Desktop/Bitbucket/MarlinV2_morphle/Marlin/src/sd/usb_flashdrive/lib-uhs3/UHS_host/UHS_hexdump.h", "C++", 0, -36, 0, 0, 0, -25, -10, -71
"/home/sanjay/Desktop/Bitbucket/MarlinV2_morphle/Marlin/src/sd/usb_flashdrive/lib-uhs3/UHS_host/UHS_host.h", "C++", 0, -61, 0, 0, 0, -33, -18, -112
"/home/sanjay/Desktop/Bitbucket/MarlinV2_morphle/Marlin/src/sd/usb_flashdrive/lib-uhs3/UHS_host/UHS_host_INLINE.h", "C++", 0, -826, 0, 0, 0, -289, -108, -1223
"/home/sanjay/Desktop/Bitbucket/MarlinV2_morphle/Marlin/src/sd/usb_flashdrive/lib-uhs3/UHS_host/UHS_macros.h", "C++", 0, -145, 0, 0, 0, -58, -28, -231
"/home/sanjay/Desktop/Bitbucket/MarlinV2_morphle/Marlin/src/sd/usb_flashdrive/lib-uhs3/UHS_host/UHS_message.h", "C++", 0, -60, 0, 0, 0, -25, -7, -92
"/home/sanjay/Desktop/Bitbucket/MarlinV2_morphle/Marlin/src/sd/usb_flashdrive/lib-uhs3/UHS_host/UHS_printf_HELPER.h", "C++", 0, -133, 0, 0, 0, -34, -34, -201
"/home/sanjay/Desktop/Bitbucket/MarlinV2_morphle/Marlin/src/sd/usb_flashdrive/lib-uhs3/UHS_host/UHS_printhex.h", "C++", 0, -56, 0, 0, 0, -25, -16, -97
"/home/sanjay/Desktop/Bitbucket/MarlinV2_morphle/Marlin/src/sd/usb_flashdrive/lib-uhs3/UHS_host/UHS_settings.h", "C++", 0, -50, 0, 0, 0, -70, -22, -142
"/home/sanjay/Desktop/Bitbucket/MarlinV2_morphle/Marlin/src/sd/usb_flashdrive/lib-uhs3/UHS_host/UHS_usb_ch9.h", "C++", 0, -144, 0, 0, 0, -53, -26, -223
"/home/sanjay/Desktop/Bitbucket/MarlinV2_morphle/Marlin/src/sd/usb_flashdrive/lib-uhs3/UHS_host/UHS_usbhost.h", "C++", 0, -236, 0, 0, 0, -139, -75, -450
"/home/sanjay/Desktop/Bitbucket/MarlinV2_morphle/Marlin/src/sd/usb_flashdrive/lib-uhs3/UHS_host/UHS_util_INLINE.h", "C++", 0, -78, 0, 0, 0, -29, -23, -130
"/home/sanjay/Desktop/Bitbucket/MarlinV2_morphle/Marlin/src/sd/usb_flashdrive/lib-uhs3/UHS_host/USB_HOST_SHIELD/UHS_max3421e.h", "C++", 0, -144, 0, 0, 0, -53, -30, -227
"/home/sanjay/Desktop/Bitbucket/MarlinV2_morphle/Marlin/src/sd/usb_flashdrive/lib-uhs3/UHS_host/USB_HOST_SHIELD/USB_HOST_SHIELD.h", "C++", 0, -354, 0, 0, 0, -106, -60, -520
"/home/sanjay/Desktop/Bitbucket/MarlinV2_morphle/Marlin/src/sd/usb_flashdrive/lib-uhs3/UHS_host/USB_HOST_SHIELD/USB_HOST_SHIELD_INLINE.h", "C++", 0, -702, 0, 0, 0, -198, -104, -1004
"/home/sanjay/Desktop/Bitbucket/MarlinV2_morphle/Marlin/src/sd/usb_flashdrive/lib-uhs3/UHS_host/macro_logic.h", "C++", 0, -112, 0, 0, 0, -9, -32, -153
"/home/sanjay/Desktop/Bitbucket/MarlinV2_morphle/Marlin/src/sd/usb_flashdrive/lib-uhs3/dyn_SWI/SWI_INLINE.h", "C++", 0, -169, 0, 0, 0, -53, -23, -245
"/home/sanjay/Desktop/Bitbucket/MarlinV2_morphle/Marlin/src/sd/usb_flashdrive/lib-uhs3/dyn_SWI/dyn_SWI.h", "C++", 0, -112, 0, 0, 0, -42, -19, -173
"Total", "-", -588, -230441, -430, -149, -976, -75543, -43843, -351970